3com	쓰리콤
4Minute	포미닛
AM ET	동부 시간 오전
AMOLED
ANA
AP	AP	연합 통신
ASEAN	아세안
Aaron	아론	애런	에런
Abba	아바
Abbas	아바스	압바스
Abdel	압델
Abdul	압둘
Abdullah	압둘라
Abe	아베	에이브
Abel	아벨
Abercrombie	아베크롬비	애버크롬비
Aberdeen	애버딘
Abidjan	아비장
Abigail	아비가일
Abraham	아브라함	에이브러햄
Abram	아브람
Abramovich	아브라모비치
Abu Dhabi	아부 다비
Abyss	어비스
Acapulco	아카풀코
Accra	아크라
Acheson	애치슨
Achilles	아킬레스	아킬레우스
Acropolis	아크로폴리스
Adam	아담	애덤
Adams	아담스	애덤스
Addie	애디
Addis Ababa	아디스 아바바
Addison	아디슨	애디슨
Adebayor	아데바요르
Adelaide	아들레이드	애들레이드
Adele	아델
Adelson	아델슨	애덜슨
Adler	애들러
Adnan	아드난
Adobe	어도비
Adolf	아돌프
Adonis	아도니스
Adria	아드리아	아드리안	애드리안
Advocaat	아드보카트
Aegean Sea	에게 해
Aerial	에어리얼
Affleck	애플렉
Afghan	아프간
Afghanistan	아프가니스탄
Africa	아프리카
Afrikaans	아프리칸스
Aftershocks	여진
Agamemnon	아가멤논
Agassi	아가시
Agatha	아가사
Agnes	아그네스
Agra	아그라
Aguilera	아길레라
Ahmad	아마드	아흐마드
Ahmadi	아마디
Ahmadinejad	아마디네자드	아흐마디네자드
Ahmed	아메드	아흐메드
Ahmet	아흐메트
Aida	아이다
Aiko	아이코
Ajax	아약스
Akasaka	아카사카
Akbar	아크바르
Aki	아키
Akihabara	아키하바라
Akihito	아키히토
Akiko	아키코
Akio	아키오
Akira	아키라
Akita	아키타
Akiyama	아키야마
Al	알	앨
Al Jazeera	알 자지라
Alabama	알라바마	앨라배마
Aladdin	알라딘
Alain	알랭
Alamo	알라모
Alan	알란	알랜	알런	앨런
Alaska	알래스카	알레스카
Alba	알바
Albania	알바니아
Albany	알바니	올버니
Albert	알버트	알베르	알베르트	앨버트
Alberta	알버타	앨버타
Alberto	알베르토
Albom	앨봄
Albright	올브라이트
Albuquerque	앨버커키
Albus	알버스
Alcatraz	알카트라즈
Alchemy	알케미
Alcoa	알코아
Aldi	알디
Alec	알렉
Alejandro	알레한드로
Aleppo	알레포
Alessandro	알레산드로
Alex	알렉스
Alexa	알렉사
Alexander	알렉산더
Alexandra	알렉산드라
Alexandre	알렉상드르
Alexandria	알렉산드리아
Alexis	알렉시스
Alfonso	알폰소
Alfred	알프레드
Alfredo	알프레도
Algeria	알제리
Algiers	알제
Ali	알리
Alibaba	알리바바
Alice	앨리스
Alicia	알리샤	앨리샤	엘리샤
Alison	알리슨
Alistair	알리스테어
Alitalia	알리탈리아
Alito	알리토
Allah	알라
Allawi	알라위
Allen	알렌	앨런	앨렌
Allende	아옌데
Allison	앨리슨
Alma	알마
Almaty	알마티
Almeida	알메이다
Almeria	알메리아
Almunia	알무니아
Aloha	알로하
Alonso	알론소
Alps	알프스
Alston	알스톤
Altman	알트만
Alvarez	알바레즈
Alves	알베스
Alvin	앨빈
Amadeus	아마데우스
Amalfi	아말피
Amanda	아만다
Amara	아마라
Amazon	아마존
Amazon River	아마존 강
Amber	앰버	엠버	호박
Ambrose	암브로스	앰브로즈
Amelia	아멜리아
Amelie	아멜리
America	미	미국	아메리카	아메리칸
Amir	아미르
Amman	암만
Amos	아모스
Amotech	아모텍
Amsterdam	암스테르담
Amundsen	아문센
Amur	아무르
Amway	암웨이
Amy	에이미
Anaheim	애너하임
Anakin	아나킨
Anastasia	아나스타샤
Anatolia	아나톨리아
Anatoly	아나톨리
Anbar	안바르
Ancelotti	안첼로티
Anders	앤더스
Andersen	안데르센
Anderson	앤더슨
Andes	안데스
Andhra	안드라
Andong	안동
Andre	안드레	앙드레
Andrea	안드레아
Andreas	안드레아스
Andres	안드레스
Andrew	앤드루	앤드류
Andrews	앤드루스	앤드류스	앤드류즈
Andrey	안드레이
Android	안드로이드
Andromeda	안드로메다
Andy	앤디
Anelka	아넬카
Angela	안젤라	앙겔라	앤젤라
Angeles	엔젤레스
Angelina	안젤리나
Angelo	안젤로
Angkor	앙코르
Angola	앙골라
Anguk	안국
Angus	앵거스
Anhui	안후이
Anita	아니타	애니타
Ankara	앙카라
Anna	안나	애나
Annapurna	안나푸르나
Anne	안네	안느
Annette	아네트
Annika	아니카
Ansan	안산
Ansar	안사르
Ansari	안사리
Anseong	안성
Antarctica	남극
Anthocyanin	안토시아닌
Anthony	안소니	안토니	앤서니	앤소니	앤써니	앤쏘니	앤토니
Antigone	안티고네
Antigua	안티구아
Antoine	앙투안
Antoinette	앙투아네트	앙트와네트
Anton	안톤
Antonia	안토니아
Antonio	안토니오
Antonius	안토니우스
Antwerp	앤트워프
Anubis	아누비스
Anwar	안와르
Anyang	안양
Aoki	아오키
Aoyama	아오야마
Aozora	아오조라
Apache	아파치
Apex	에이펙스
Apgujeong	압구정
Aphrodite	아프로디테
Apollo	아폴로
Appalachian	애팔래치아
Appleby	애플비
Appleton	애플턴
Aquinas	아퀴나스
Aquino	아키노
Arab	아랍
Arab League	아랍연맹
Arabian	아라비아
Arabic	아랍
Arafat	아라파트
Arai	아라이
Aral Sea	아랄해
Aramis	아라미스
Arc de Triomphe	개선문
Archimedes	아르키메데스
Arctic Ocean	북극해
Arenas	아레나스
Ares	아레스
Argentina	아르헨티나
Argo	아르고
Arias	아리아스
Ariel	아리엘
Arion	아리온
Arirang	아리랑
Aristotle	아리스토텔레스
Arisu	아리수
Arizona	아리조나	애리조나
Arkansas	아칸소
Arlington	알링턴
Armageddon	아마겟돈
Armani	아르마니	알마니
Armenia	아르메니아
Armitage	아미타지	아미티지
Armstrong	암스트롱
Arnold	아널드	아놀드
Arroyo	아로요
Arsenal	아스널
Arsene	아르센
Arshavin	아르샤빈
Art Nouveau	아르누보
Artemis	아르테미스
Arthur	아더	아서
Aruba	아루바
Asadal	아사달
Asahi	아사히
Asakusa	아사쿠사
Asan	아산
Asgard	아스가르드
Asha	아샤
Ashley	애쉴리	애슐리
Ashton	애쉬턴	애쉬톤	애쉬튼	애슈턴
Asia	아시아	아시안
Asia Pacific	아시아 태평양	아태
Asian Development Bank	아시아 개발 은행
Asiana Airlines	아시아나항공
Asianux	아시아눅스
Asif	아시프
Asimov	아시모프
Aso	아소
Asoka	아소카
Asperger	아스퍼거
Assad	아사드
Associated Press	AP	연합 통신
Assyria	아시리아
Aston	아스톤	애스턴	애스톤
Astra	아스트라
Astrid	아스트리드
Astro	아스트로
Astrolabe	아스트롤라베
Aswan	아스완
Atacama	아타카마
Atari	아타리
Athena	아테나
Athens	아테네
Atkins	앳킨스
Atlanta	애틀란타	애틀랜타
Atlantic	대서양	애틀랜틱
Atlas	아틀라스
Atta	아타
Atwood	애트우드
Auckland	오클랜드
Auction	Auction	경매	옥션
Audi	아우디
Audrey	오드리
August	8월	어거스트	팔월
Augustine	아우구스티누스	아우구스틴	어거스틴
Augustus	아우구스투스
Aurelius	아우렐리우스
Auschwitz	아우슈비츠
Austin	오스틴
Australia	오스트레일리아	호주
Australopithecus	오스트랄로피테쿠스
Austria	오스트리아
Autobahn	아우토반
Avalon	아발론
Avery	에이버리
Avid	아비드
Avignon	아비뇽
Avila	아빌라
Avril	에이브릴
Ayako	아야코
Ayala	아얄라
Ayatollah	아야톨라
Ayutthaya	아유타야
Azerbaijan	아제르바이잔
Aziz	아지즈
Aztec	아즈텍
BC Card	비씨카드
BIOS	바이오스
Baba	바바
Babel	바벨
Babylon	바빌론
Babylonia	바빌로니아
Bach	바흐
Bachelet	바첼렛
Baek Ji Young	백지영
Baez	바에즈
Baghdad	바그다드
Bagram	바그람
Bahamas	바하마
Bahrain	바레인
Baidu	바이두
Baikal	바이칼
Baikonur	바이코누르
Bailey	베일리
Baird	베어드
Baku	바쿠
Baldwin	볼드윈
Balhae	발해
Bali	발리
Balkan	발칸
Ballmer	발머
Baltic	발트	발틱
Baltic Sea	발트해
Baltimore	볼티모어
Balzac	발자크
Bamako	바마코
Bambi	밤비
Bamiyan	바미얀
Banana Boat	바나나보트
Bancroft	밴크로프트
Bandai	반다이
Bandar	반다르
Banderas	반데라스
Bangalore	방갈로르
Bangkok	방콕
Bangladesh	방글라데시
Banpo	반포
Bao	바오
Barack	버락
Barack Obama	버락 오바마	오바마
Barbados	바베이도스
Barbara	바바라	바버라
Barbaro	바르바로
Barcelona	바르셀로나
Barclay	바클레이
Barclays	바클레이스
Barker	바커
Barkley	바클리
Barnes	바네스	반스	반즈
Barnett	바넷
Barney	바니
Barnsley	반즐리
Baros	바로스
Barre	바레
Barrett	바렛	배럿
Barron	배런
Barry	배리
Barrymore	배리모어	베리모어
Bart	바트
Bartlett	바틀렛
Bartok	바르톡
Barton	바튼
Baruch	바뤼흐
Basayev	바사예프
Basel	바젤
Bashar	바샤르
Bashir	바쉬르	바시르
Basilica	바실리카
Basque	바스크
Basquiat	바스키아
Basra	바스라
Bastille	바스티유
Bates	베이츠
Batista	바티스타
Battaille	바타이유
Baudelaire	보들레르
Bauer	바우어
Bavaria	바바리아
Baxter	백스터
Bayer	바이엘
Bear Stearns	베어스턴스
Beatles	비틀스	비틀즈
Beatrice	베아트리체
Beatrix	베아트릭스
Becca	베카
Beck	벡
Becker	베커	벡커
Beckett	베케트	베켓
Beckham	베컴
Becks	벡스
Becky	베키
Bedford	베드포드
Bedouin	베두인족
Beethoven	베토벤
Beijing	베이징	북경
Beirut	베이루트
Belarus	벨라루스	벨로루시
Belfast	벨파스트
Belgium	벨기에
Belgrade	베오그라드
Bella	벨라
Bellamy	벨라미
Bellatrix	벨라트릭스
Bellman	벨맨
Belmont	벨몬트
Belvedere	벨베데레
Ben	벤
BenQ	벤큐
Benazir	베나지르
Benedict	베네딕트
Benetton	베네통
Bengal	벵골
Benghazi	벵가지
Benitez	베니테스	베니테즈
Benito	베니토
Benjamin	베냐민	벤자민	벤저민
Bennett	베네트	베넷
Bennington	베닝턴
Benny	베니
Benson	벤슨
Bentham	벤담
Bentley	벤틀리
Benton	벤튼
Benz	벤츠
Beowulf	베오울프
Berbatov	베르바토프
Bergen	베르겐
Berger	베르거
Bering	베링
Berkeley	버클리
Berkshire	버크셔
Berlin	베를린
Berlusconi	베를루스코니
Bernanke	버냉키
Bernard	버나드	베르나르
Bernardo	베르나르도
Bernie	베르니
Bernini	베르니니
Bernstein	번스타인
Berry	베리
Bertrand	베르트랑
Betancourt	베탕쿠르
Beth	베스
Bethany	베서니
Bethesda	베데스다
Bethlehem	베들레햄	베들레헴
Betsy	베시	벳시
Betty	베티
Beverly	베버리	베벌리	비버리	비벌리
Beverly Hills	비버리 힐즈	비벌리 힐스
Bevin	베빈
Beyonce	비욘세
Bezos	베조스
Bhutto	부토
Bianca	비앙카
Big Ben	빅벤
Big Film	빅필름
Bihar	비하르
Bilbao	빌바오
Bill Clinton	빌 클린턴
Bill Gates	빌 게이츠
Billings	빌링스
Billy	빌리
Bin Laden	빈라덴
Birmingham	버밍엄	버밍햄	버밍험
Bismarck	비스마르크
Bixby	빅스비
Bizet	비제
Black Sea	흑해
Blackburn	블랙번
Blackpool	블랙풀
Blackwell	블랙웰
Blaine	블레인
Blair	블레어
Blake	블래이크	블레이크
Blanc	블랑
Blanco	블랑코
Blatter	블래터
Bloch	블로흐
Blonsky	블론스키
Bloomberg	블룸버그
Bloomfield	블룸필드
Blue House	청와대
Boa	보아
Bob	밥	보브	봅
Boba	보바
Bobby	바비	보비
Boca	보카
Bocelli	보첼리
Boeing	보잉
Bogart	보가트
Bogota	보고타
Bokwang	보광
Bolden	볼든
Bolivar	볼리바르
Bolivia	볼리비아
Bollywood	볼리우드
Bologna	볼로냐
Bolshevik	볼셰비키
Bolshoi	볼쇼이
Bolton	볼턴	볼튼
Boltzmann	볼츠만
Bombay	봄베이
Bonaparte	보나파르트
Bone China	본차이나
Bongpyeong	봉평
Bonham	본햄
Bonnie	보니
Bono	보노
Booker	부커
Booz	부즈
Boracay	보라카이
Bordeaux	보르도
Boris	보리스
Borneo	보르네오
Boryeong	보령
Boseong	보성
Bosnia	보스니아
Boston	보스턴	보스톤
Boswell	보스웰
Bosworth	보스워스
Bouillabaisse	부야베스
Bourbon	버번
Bowen	보웬
Boyle	보일
Brad	브래드
Bradbury	브래드버리
Bradley	브래들리
Bradshaw	브래드쇼
Brady	브래디
Braga	브라가
Bragg	브래그
Brahma	브라마
Brahms	브람스
Brando	브란도
Brandon	브랜든
Brandt	브란트
Branson	브랜슨
Brasilia	브라질리아
Bratislava	브라티슬라바
Brazil	브라질
Bremen	브레멘
Brenda	브렌다
Brendan	브렌단
Brennan	브레넌
Brenner	브레너
Brent	브렌트
Brett	브렛
Brian	브라이언
Bridget	브리짓
Brie	브리
Brighton	브라이턴	브라이튼
Brill	브릴
Brio	브리오
Brisbane	브리스번	브리즈번
Bristol	브리스톨	브리스틀
Brit	브릿
Britain	브리튼	영국
Britannia	브리타니아
Britannica	브리태니커
British	브리티쉬	브리티시	영국	영국인
British Museum	대영 박물관
Britney	브리트니
Britney Spears	브리트니 스피어스
Brittany	브리타니
Broadcom	브로드컴
Broadway	브로드웨이
Brock	브록
Broder	브로더
Brody	브로디
Brokeback	브로크백
Bromley	브롬리
Bronson	브론슨
Bronte	브론테
Bronx	브롱크스
Brook	브루크	브룩
Brookings	브루킹스
Brooklyn	부룩클린	브루클린	브룩클린
Brooks	브룩스
Brosnan	브로스넌
Bruce	부르스	브루스
Bruce Lee	부르스 리	이소룡
Bruins	브루인스
Brunei	브루나이
Brunel	브루넬
Bruno	브루노
Brussels	브뤼셀
Brutus	브루투스
Bryant	브라이언트
Bryce	브라이스
Buchanan	뷰캐넌
Bucharest	부쿠레슈티
Bucheon	부천
Buckingham	버킹검	버킹엄	버킹햄
Budapest	부다페스트
Buddha	부처	불	석가
Buenos Aires	부에노스아이레스
Buffalo	버팔로	버펄로
Buffett	버핏
Buick	뷰익
Bukchon	북촌
Bulgaria	불가리아
Bulguksa Temple	불국사
Bund	번드
Bundy	번디
Burberry	버버리
Burger	버거
Burger King	버거킹
Burgundy	버건디	부르고뉴
Burj	부르즈
Burke	버크
Burley	벌리
Burma	미얀마	버마
Burrell	버렐
Burt	버트
Burundi	부룬디
Burwell	버웰
Busan	부산
Busan Bank	부산은행
Butch	부치
Butler	버틀러
Byron	바이런
Byzantine	비잔틴
Byzantium	비잔티움
CAD	CAD	캐드
COEX	코엑스
COEX Mall	코엑스몰
COWON SYSTEM	코원시스템
Cabral	카브랄
Cabrera	카브레라
Caesar	시저	카이사르
Caesars	시저스
Cagliari	칼리아리
Cahill	카힐
Cain	카인
Cairns	케언스	케언즈
Cairo	카이로
Calais	칼레
Calcutta	캘커타
Calderon	칼데론
Caldwell	칼드웰	콜드웰
Caleb	칼렙
Calgary	캘거리
California	캘리포니아
Callas	칼라스
Calligraphy	서도
Calvin	캐빈	캘빈	켈빈
Calypso	칼립소
Camacho	카마초
Camara	카마라
Cambodia	캄보디아
Cambridge	케임브리지
Cameron	카메론	캐머런	캐머론
Cameron Diaz	카메론디아즈
Cameroon	카메룬
Camilla	카밀라
Camille	카미유	카밀
Campbell	캠벨	캠블	캠프벨
Campo	캄포
Camus	카뮈
Can Tho	깐토	껀터	칸토
Canaan	가나안
Canada	캐나다
Canadian	캐나다	캐나디안	캐내디언
Canas	카나스
Canberra	캔버라
Cancun	칸쿤
Cannes	깐느	칸	칸느
Canterbury	캔터베리
Cantonese	광동	광둥
Cantor	칸토어
Cape Town	케이프 타운
Capello	카펠로
Cappadocia	카파도키아
Caracas	카라카스
Cardiff	카디프
Cardinals	카디널스
Caribbean	카리브	캐러비언
Carlo	카를로
Carlos	카를로스	칼로스
Carlson	칼슨
Carlton	칼튼
Carlyle	칼라일
Carmelo	카멜로
Carmen	카르멘
Carnegie	카네기
Carnegie Hall	카네기홀
Carney	카니
Carol	캐럴	캐롤	케롤
Carolina	캐롤라이나	캐롤리나
Caroline	캐롤라인
Carolyn	캐롤린
Caron	캐론
Carpenter	카펜터
Carragher	캐러거
Carrefour	까르푸	카르푸
Carreras	카레라스
Carrington	캐링턴
Carson	카슨
Carta	카르타
Carter	카터
Carthage	카르타고
Cartier	까르띠에	카르티에
Caruso	카루소
Carver	카버
Casa	카사
Casablanca	카사블랑카
Casanova	카사노바
Casey	케이시
Casillas	카시야스
Casio	카시오
Casper	캐스퍼
Caspian	카스피
Cassandra	카산드라
Cassidy	캐시디
Cassini	카시니
Castro	카스트로
Catalonia	카탈로니아	카탈루냐
Catania	카타니아
Catherine	캐서린
Cato	카토
Catwoman	캣우먼
Caucasus	코카서스
Cavendish	캐번디시
Cavill	카빌
Cebit	세빗
Cech	체흐
Cecil	세실
Cecilia	세실리아
Cedric	세드릭
Celia	셀리아
Celine	셀린
Celtic	셀틱	켈트	켈틱
Celtics	셀틱스
Central America	중앙 아메리카
Central Asia	중앙 아시아
Central Park	센트럴 공원	센트럴 파크
Central Station	센트럴 스테이션	중앙역
Cervantes	세르반테스
Cesar	세자르
Cesc	세스크
Cessna	세스나
Cezanne	세잔
Chad	차드	채드
Chagall	샤갈
Chamberlain	체임벌린
Chamonix	샤모니
Champions League	챔피언스 리그	챔피언즈 리그
Champs Elysees	샹젤리제
Chan	챈
Chandra	찬드라
Chanel	샤넬
Changchun	장춘	창춘
Changmin	창민
Changwon	창원
Channing	채닝
Chaozhou	조주	차오저우
Chaplin	채플린
Chapman	채프먼
Chardonnay	샤르도네
Charlemagne	샤를마뉴
Charlene	샬린
Charles	샤를	샤를르	찰스	챨스
Charlie	찰리	챨리
Charlize	샤를리즈
Charlotte	샬럿	샬로트	샬롯
Charlton	찰턴	찰튼
Chaucer	초서
Chavez	차베스
Chechen	체첸
Cheil	제일
Chelsea	첼시
Chen	첸
Cheney	체니
Cheng	쳉
Chengdu	청두
Cheonan	천안
Cheonggye	청계
Cheonggyecheon	청계천
Cheonghae	청해
Cheongju	청주
Cheongnyangni	청량리
Chernobyl	체르노빌
Cherokee	체로키	체로키족
Cheryl	셰릴	쉐릴
Chester	체스터
Chestnut	체스트넛
Cheyenne	샤이엔
Chiang Mai	치앙마이
Chiba	지바	치바
Chicago	시카고
Chico	치코
Chihiro	치히로
Chile	칠레
China	중	중국	차이나
China Unicom	차이나 유니콤
Chinese	중	중국	중국어	중국인	한
Chirac	시라크
Chittagong	치타공
Chivas	시바스
Chlamydia	클라미디아
Chloe	클로이
Chocolate	쇼콜라	초코	초콜렛	초콜릿
Choheung	조흥
Choi	최
Choi Si Won	최시원
Choi Young	최영
Chomsky	촘스키
Chongqing	충칭
Chopin	쇼팽
Chosun Hotel	조선호텔
Chosun Ilbo	조선일보
Chow	차우
Christchurch	크라이스트처치
Christensen	크리스텐슨
Christian	크리스챤	크리스천	크리스티안	크리스티앙
Christie	크리스티
Christina	크리스티나
Christine	크리스틴
Christoph	크리스토프
Christopher	크리스토퍼
Chrysler	크라이슬러
Chungbuk	충북
Chungcheong	충청
Chungju	충주
Chungmu	충무
Chungmuro	충무로
Chungnam	충남
Chunhyang	춘향
Churchill	처칠
Cicero	키케로
Cincinnati	신시내티
Cinderella	신데렐라
Cindy	신디
Cisco	시스코
City Hall	시청	시티 홀
City Hall Station	시청 역
Claire	클레어
Clancy	클랜시
Clapton	클랩튼
Clara	클라라
Clarence	클라렌스	클래런스
Clark	클라크	클락
Claude	클로드
Claudel	클로델
Claudia	클라우디아	클로디아
Claudio	클라우디오
Claudius	클라우디우스
Clausewitz	클라우제비츠
Clayton	클레이튼
Clegg	클레그
Clemens	클레멘스
Cleo	클레오
Cleopatra	클레오파트라
Cleveland	클리브랜드	클리블랜드
Clifford	클리포드
Clint	클린트
Clinton	클린턴
Clive	클라이브
Clooney	클루니
Clyde	클라이드
Coaster	코스터
Cobain	코베인
Coburn	코번
Coco	코코
Coelho	코엘류
Coen	코엔
Cohen	코헨
Colchester	콜체스터
Cold War	냉전
Coleman	콜만	콜맨	콜먼
Coles	콜스
Colgate	콜게이트
Collier	콜리어
Collins	콜린스	콜린즈
Cologne	쾰른
Colombo	콜롬보
Colorado	콜로라도
Colton	콜튼
Colts	콜츠
Columbia	컬럼비아	콜롬비아
Columbus	컬럼버스	콜럼버스
Com2uS	컴투스
Combs	콤스
Commonwealth	영연방
Communist Party	공산당
Compaq	컴팩
Conan	코난
Concord	콩코드
Condoleezza	콘돌리자
Confucius	공자
Congo	콩고
Connecticut	코네티컷
Connelly	코넬리
Connery	코네리
Connie	코니
Connolly	코놀리
Conrad	콘라드	콘래드
Conservative Party	보수당
Constance	콘스탄스
Constantine	콘스탄티누스	콘스탄틴
Constantinople	콘스탄티노플
Contra	콘트라
Conway	콘웨이
Coors	쿠어스
Copa	코파
Copenhagen	코펜하겐
Copernicus	코페르니쿠스
Copperfield	카퍼필드
Coppola	코폴라
Cora	코라
Corbett	코베트
Corey	코리
Corinne	코린
Cornell	코넬
Corning	코닝
Cornwall	콘월
Corolla	코롤라
Correa	코레아
Corsica	코르시카
Cortes	코르테스
Corvette	콜벳
Cosby	코스비
Cosmo	코스모
Costa Rica	코스타 리카
Costco	코스트코
Costner	코스트너
Coumarin	쿠마린
Courtney	커트니	코트니
Cove	코브
Cowell	코웰
Cowon	코원
Craig	크레그	크레이그	크렉
Craven	크레이븐
Crawford	크로퍼드	크로포드
Crawley	크롤리
Cray	크레이
Creamer	크리머
Creatine	크레아틴
Crete	크레타
Cristo	크리스토
Croatia	크로아티아
Crochet	크로셰
Crocker	크로커
Croft	크로프트
Cromwell	크롬웰
Cronin	크로닌
Crosby	크로스비
Crouch	크라우치
Crowell	크로웰
Crusoe	크루소
Cuba	쿠바
Cubs	컵스
Cuckoo	쿠쿠
Cumbria	컴브리아
Cummings	커밍스
Cunningham	커닝햄
Cuomo	쿠오모
Cupid	큐피드	큐피트
Curie	퀴리
Curtis	커티스
Cusco	쿠스코
Cushing	쿠싱
Cynthia	신시아
Cyprus	키프로스
Cyrus	사이러스	키루스
Czech	체코
Czechoslovakia	체코슬로바키아
Da Vinci	다 빈치
Dabotap	다보탑
Dacom	데이콤
Dade	데이드
Daecheon	대천
Daedeok	대덕
Daegu	대구
Daegu Bank	대구 은행
Daegwallyeong	대관령
Daeheung	대흥
Daejeon	대전
Daelim	대림
Daesung	대성
Daewoo	대우
Daewoo Electronics	대우 일렉트로닉스	대우 전자
Dagestan	다게스탄
Daiichi	다이치
Daikanyama	다이칸야마
Daimler	다임러
Daisuke	다이스케
Dakar	다카르
Dakota	다코타
Dalai	달라이
Dalai Lama	달라이 라마
Dale	데일
Dalek	달렉
Dali	달리
Dalian	다롄	대련
Dallas	달라스	댈러스
Dalton	달튼	돌턴
Daly	댈리
Damascus	다마스쿠스
Damian	데미안
Damien	데미언
Damon	데이먼
Damyang	담양
Dan	단	댄
Dana	다나	데이나
Dandong	단둥
Dane	데인
Daniel	다니엘	대니얼	대니엘
Daniela	다니엘라
Daniels	다니엘스
Danish	대니쉬	대니시	데니쉬	데니시	덴마크
Danny	대니
Dante	단테
Danube	다뉴브
Danube River	다뉴브 강
Daphne	다프네
Darfur	다르푸르
Darnell	다넬
Darren	다렌	대런
Dartmouth	다트머스
Darwin	다윈
Darwinism	다윈설
Dave	데이브
Davenport	데이븐포트
David	다비드	다윗	데이비	데이비드	데이빗
Davidson	데이비드슨	데이비슨
Davis	데이비스
Davos	다보스
Dawkins	도킨스
Dawson	도슨
Dayton	데이톤
De	데	드
De Gaulle	드골
Dead Sea	사해
Dearborn	디어본
Debbie	데비
Deborah	데보라
Debra	데브라
Debug	디버그
Debussy	드뷔시
Deco	데코
Defoe	데포
Delaney	델라니
Delano	델라노
Delaware	델라웨어
Delgado	델가도
Delhi	델리
Delia	델리아
Dell	델
Della	델라
Delphi	델피
Dementieva	데멘티에바
Demeter	데메테르
Demi	데미
Democratic Labor Party	민노당	민주노동당
Democratic Party	민주당
Dempsey	뎀시	뎀프시
Dench	덴치
Deng	덩
Deng Xiaoping	덩샤오핑
Denis	드니스
Denmark	덴마크
Denver	덴버
Denzel	덴젤
Depot	디포
Depp	뎁
Der	더	데르
Derby	더비
Derbyshire	더비셔
Derek	데렉
Des Moines	디모인
Descartes	데카르트
Desmond	데스몬드
Detroit	디트로이트
Deutsche	도이체	도이치
Devin	데빈
Devon	데본
Dewey	듀이
Dexter	덱스터
Deyoung	드영
Dhaka	다카
Diablo	디아블로
Diana	다이아나	다이애나	다이애너	디아나
Diane	다이안	다이앤
Dias	디아스
Diaspora	디아스포라
Diaz	디아즈
Dicaprio	디카프리오
Dick	딕
Dickens	디킨스	디킨즈
Dickinson	디킨슨
Diddy	디디
Didier	디디에르
Diego	디에고
Dietrich	디트리히
Digimon	디지몬
Dilbert	딜버트
Dili	딜리
Dimaggio	디마지오
Dimitar	디미타르
Dimitri	디미트리
Dimon	다이먼
Dina	디나
Dino	디노
Diocletian	디오클레티아누스
Dion	디온	디옹
Dionysus	디오니소스
Dior	디오르
Dios	디오스
Diouf	디우프
Dirk	더크
Disney	디즈니
Diva	디바
Diwaniya	디와니야
Dixie	딕시
Dixon	딕슨
Diyarbakir	디야르바키르
Djibouti	지부티
Djokovic	조코비치
Dmitry	드미트리
Dobson	돕슨
Dodgers	다저스
Doha	도하
Doherty	도허티
Dokdo	독도
Dolly	돌리
Dolores	돌로레스
Domenech	도메네크
Domingo	도밍고
Dominic	도미닉
Dominican	도미니카
Dominique	도미니크
Don Quixote	돈키호테	동키호테
Donahue	도나휴
Donald	도날드	도널드
Donaldson	도날드슨
Dongbu	동부
Dongducheon	동두천
Dongju	동주
Dongkuk	동국
Dongwoo	동우
Donna	도나
Donnell	도넬
Donnelly	도넬리
Donny	도니
Donovan	도노반
Doorman	도어맨
Doosan	두산
Doppler	도플러
Dora	도라
Doraemon	도라에몽
Doris	도리스
Dorothy	도로시
Dortmund	도르트문트
Dos	도스
Dostoevsky	도스토예프스키
Doug	더그
Douglas	더글라스	더글러스
Dover	도버
Dow	다우
Dow Jones	다우 존스
Dowd	다우드
Downer	다우너
Downing	다우닝
Doyle	도일
Dracula	드라큘라
Dragon Ball	드래곤 볼
Draper	드레이퍼
Dreamworks	드림웍스
Dresden	드레스덴
Drexel	드렉셀
Dreyfus	드레퓌스
Drucker	드러커
Drummond	드러몬드
Dubai	두바이	듀바이
Dublin	더블린
Duchamp	뒤샹
Dudley	더들리
Dulles	덜레스
Dumas	뒤마
Duncan	던칸	던컨	덩컨
Dungeon	던전
Dunhill	던힐
Dunkin	던킨
Dunn	던
Dunst	던스트
Duomo	두오모
Dupont	듀폰	듀퐁
Duran	듀란
Durbin	더빈
Durga	두르가
Durham	더럼	더햄
Dustin	더스틴
Dutch	네덜란드	더치
Dvorak	드보르작
Dwight	드와이트
Dylan	딜란	딜런
Earl Grey	얼 그레이
East Africa	동 아프리카
East Asia	동 아시아
East China Sea	동중국해
East Germany	동독
East India	동인도
East Sea	동해
Easter	부활절	이스터
Easter Island	이스터 섬
Eastern Europe	동 유럽	동구
Eastman	이스트먼
Eastwood	이스트우드
Ecuador	에콰도르
Ed	에드
Eddie	에디
Edelman	에델만
Eden	에덴
Edgar	에드가	에드거
Edinburgh	에든버러
Edison	에디슨
Edith	에디스
Edmonds	에드먼즈
Edmund	에드먼드	에드문드
Edo	에도
Edouard	에두아르
Eduardo	에두아르도
Edward	에드워드
Edwards	에드워즈
Edwin	에드윈
Egypt	이집트
Ehud	에후드
Eiffel	에펠
Eiffel Tower	에펠	에펠 타워	에펠 탑
Eiko	에이코
Eileen	에일린
Einstein	아인슈타인
Eisenhower	아이젠하워
El Baradei	엘 바라데이
El Salvador	엘 살바도르
Elaine	일레인
Elbe River	엘베 강
Eleanor	엘레노어	엘리너	엘리노어
Electra	엘렉트라
Electron	일렉트론
Elena	엘레나	엘리나
Elf	엘프
Elgar	엘가
Elgin	엘긴
Elias	엘리아스
Elijah	엘리야
Elin	엘린
Elisha	엘리샤
Eliza	엘리자
Elizabeth	엘리자베스
Ella	엘라
Elle	엘르
Ellen	엘런	엘렌
Ellington	엘링턴
Elliot	엘리어트
Elliott	엘리엇
Ellis	엘리스
Ellison	엘리슨
Elmore	엘모어
Elon	엘론
Elpida	엘피다
Els	엘스
Elsa	엘사
Elton	엘튼
Elvis	엘비스
Elwood	엘우드
Elysee	엘리제
Emerson	에머슨
Emily	에밀리
Eminem	에미넴
Emirates	에미레이트	에미리트
Emma	에마	엠마
Emmanuel	에마누엘	엠마누엘	엠마뉴엘
Emory	에모리
Empas	엠파스
Enceladus	엔셀라두스	엔켈라두스
Endeavor	인데버
Enders	엔더스
Energizer	에너자이저
Engel	엥겔
Engels	엥겔스
England	영	영국	잉글랜드
English	영	영국	잉글랜드
Eno	에노
Enoch	에녹
Enrico	엔리코
Enrique	엔리케
Enron	엔론
Epicurus	에피쿠로스
Epson	엡손
Epstein	엡스타인
Erasmus	에라스무스
Erdogan	에르도간
Eri	에리
Eric	에릭
Erica	에리카
Erich	에리히
Ericsson	에릭슨
Eritrea	에리트레아	에리트리아
Ernest	어네스트	어니스트
Ernesto	어네스토
Ernie	어니
Ernst	에른스트
Espada	에스파다
Esperanto	에스페란토
Esquire	에스콰이어
Essex	에섹스
Estefan	에스테판
Estelle	에스텔
Esther	에스더
Estonia	에스토니아
Estrada	에스트라다
Ethan	에단
Ethiopia	에티오피아
Etna	에트나
Eto	에토
Eton	이튼
Etsuko	에츠코
Eucalyptus	유칼립투스
Euclid	유클리드
Eugene	유진
Euler	오일러
Eunice	유니스
Eunpyeong	은평
Euphrates	유프라테스
Eurasia	유라시아
Eureka	유레카
Euro	유로
Europa	유로파
Europe	구	유럽
European Union	EU	유럽 연합
Eurozone	유로존
Eva	에바
Evan	에반
Evans	에반스	에번스
Evelyn	에블린
Everest	에베레스트
Everett	에버렛
Everglades	에버글레이즈
Evergreen	에버그린
Everland	에버랜드
Everton	에버튼
Evian	에비앙
Evita	에비타
Evo	에보
Evra	에브라
Ewha	이화
Exchange Bank	외환 은행
Exeter	엑서터	엑스터	엑시터
Exorcism	엑소시즘
Exorcist	엑소시스트
Exxon	엑슨
Ezra	에즈라
FIFA	FIFA	피파
FKI	전경련
Fabio	파비오
Fabius	파비우스
Fabre	파브르
Fabregas	파브레가스
Fairchild	페어차일드
Fairfax	페어팩스
Faisal	파이살
Falklands	포클랜드
Fallon	팰런	팰론
Fallujah	팔루자
Falun Gong	파룬궁
Familia	파밀리아
Far East	극동
Farrell	파렐	패럴
Fatima	파티마
Faulkner	포크너
Faust	파우스트
Fayed	파예드
Federal Reserve	연방 준비
Federer	페더러
Federico	페데리코
Fedex	페덱스
Felicity	펠리시티
Felipe	펠리페
Felix	펠릭스
Felton	펠튼
Ferdinand	퍼디난드	퍼디낸드	페르디난드	페르디난트
Ferguson	퍼거슨
Fermat	페르마
Fermi	페르미
Fermin	페르민
Fernandez	페르난데즈
Fernando	페르난도
Ferrara	페라라
Ferrari	페라리
Ferraro	페라로
Ferrer	페러
Ferris	페리스
Ferro	페로
Fez	페즈
Fiat	피아트
Fidel	피델
Fiesta	피에스타
Figaro	피가로
Fillmore	필모어
Finland	핀란드
Finley	핀리
Fiona	피오나
Fiorina	피오리나
Fisher	피셔
Fitzgerald	피츠제랄드	피츠제럴드
Flanders	플랑드르
Fleming	플레밍
Fletcher	플레처
Flint	플린트
Flora	플로라
Florence	플로렌스	피렌체
Flores	플로레스
Florida	플로리다
Flynn	플린
Fonda	폰다
Fondue	퐁듀
Fontaine	폰테인
Forbes	포브스
Foreman	포먼	포어맨
Fort Worth	포트워스
Foucault	푸코
Fourier	푸리에
Fowler	파울러
Fran	프랜
Frence	불	불란서	프랑스	프렌치	후렌치
Francesca	프란체스카
Francesco	프란체스코
Francine	프랜신
Francis	프란시스	프란치스코	프랜시스
Francisco	프란시스코
Franco	프란코	프랑코
Francois	프랑소와	프랑수아
Franken	프랑켄
Frankenstein	프랑켄슈타인
Frankfurt	프랑크푸르트
Frankie	프랭키
Franklin	프랭클린	플랭클린
Franks	프랭크스
Frans	프란스
Franz	프란츠
Fraser	프레이저
Fred	프레드
Freddy	프레디
Frederick	프레더릭	프레데릭	프레드릭
Freeman	프리맨	프리먼
Freetel	프리텔
Fremont	프리몬트
French	불	불란서	프랑스	프렌치	후렌치
Fresno	프레즈노
Freud	프로이드	프로이트
Friday	금	금요일	프라이데이
Friedman	프리드만	프리드먼
Friedrich	프리드리히
Frisbee	프리스비
Fritz	프리츠
Frodo	프로도
Fuji	후지
Fujian	푸젠
Fujimori	후지모리
Fujita	후지타
Fujitsu	후지쓰	후지쯔
Fukuda	후쿠다
Fukui	후쿠이
Fukuoka	후쿠오카
Fukushima	후쿠시마
Fukuzawa	후쿠자와
Fulbright	풀브라이트
Fulham	풀럼
Fuller	풀러
Fulton	풀턴
Fumio	후미오
Fyodor	표도르
Gabbana	가바나
Gabe	게이브
Gabon	가봉
Gabriel	가브리엘
Gaddafi	카다피
Gag Concert	개그 콘서트	개콘
Gagarin	가가린
Gaia	가이아
Gala	갈라
Galapagos	갈라파고스
Galaxy	갤럭시
Galbraith	갤브레이스
Galicia	갈리시아
Galilee	갈릴리
Galilei	갈릴레이
Galileo	갈릴레오
Gallagher	갤러거
Gallas	갈라스
Gallo	갈로
Galois	갈루아
Gandalf	간달프
Gandhi	간디
Gando	간도
Gandolfini	갠돌피니
Ganesha	가네샤
Gangdong	강동
Ganges	갠지스
Ganges River	갠지스 강
Ganghwa Island	강화도
Gangnam	강남
Gangnam Station	강남역
Gangneung	강릉
Gangwon	강원
Gao	가오
Gapyeong	가평
Garcia	가르시아
Gardner	가드너
Gareth	가레스
Garfield	가필드
Garland	갈런드
Garner	가너
Garrett	가렛
Garrison	개리슨	게리슨
Gartner	가트너
Garuda	가루다
Gary	개리	게리
Gateshead	게이츠헤드
Gatsby	개츠비
Gaudi	가우디
Gauguin	고갱
Gaul	갈리아
Gauss	가우스
Gavin	가빈
GeForce	지포스
Gebrselassie	게브르셀라시에
Gemma	젬마
Genesis	제네시스	창세기
Geneva	제네바
Genghis Khan	징기스 칸	칭기즈 칸
Genie	지니
Genoa	제노바	제노아
Geoje	거제
George	조오지	조지	죠오지	죠지
George Washington	조지 워싱턴
Georges	조르주
Georgetown	조지타운
Georgia	그루지야	조지아
Geotel	지오텔
Gerald	제랄드	제럴드
Geraldine	제랄딘
Gerhard	게르하르트
Germain	제르맹
German	독	독일
Germanic	게르만
Germany	독	독일
Geronimo	제로니모
Gertrude	거트루드
Getty	게티
Gettysburg	게티즈버그
Ghana	가나
Ghazni	가즈니
Ghibli	지브리
Gianni	지아니
Gibbons	기번스
Gibraltar	지브롤터
Gibran	지브란
Gibson	깁슨
Giggs	긱스
Gilbert	길버트
Gilberto	질베르토
Giles	자일스
Gilgamesh	길가메시
Gillespie	길레스피
Gillette	질레트
Gillian	길리안	질리언
Gilmore	길모어
Gimhae	김해
Gimpo	김포
Gingrich	깅리치
Ginza	긴자
Giordano	지오다노
Giovanni	지오바니	지오반니
Girardi	지라디
Giuliani	줄리아니
Givenchy	지방시
Gladstone	글래드스톤
Gladwell	글래드웰
Glasgow	글라스고	글래스고
Gleason	글리슨
Glen	글렌
Glendale	글렌데일
Glitter	글리터
Gloria	글로리아
Gloucester	글로스터
Glover	글로버
Gobi Desert	고비 사막
Goblin	고블린
Goddard	고다드
Godwin	고드윈
Godzilla	고질라
Goebbels	괴벨스
Goethe	괴테
Gogh	고호	고흐
Goguryeo	고구려
Goheung	고흥
Gojong	고종
Gojoseon	고조선
Goku	오공
Gold Coast	골드 코스트
Goldberg	골드버그
Golden Gate	골든 게이트
Goldilocks	골디락스
Goldin	골딘
Goldman	골드만	골드먼
Goldsmith	골드스미스
Goldstein	골드스타인
Goliath	골리앗
Gomez	고메즈
Gomorrah	고모라
Gonzales	곤잘레스
Gonzalez	곤살레스
Goodman	굿맨
Goran	고란
Gorbachev	고르바초프
Gordon	고든
Gordon Brown	고든 브라운
Gore	고어
Goto	고토
Gouda	고다
Gould	굴드
Goya	고야
Goyang	고양
Grady	그래디
Graham	그래엄	그래햄	그래험	그레이엄	그레이험
Grammy	그래미
Granada	그라나다
Grand Canyon	그랜드 캐년	그랜드 캐니언	그랜드 케니언
Grand National Party	한나라당
Grande	그란데
Granville	그랜빌
Graz	그라츠
Great Britain	대영 제국	영국
Great Wall	만리장성
Greco	그레코
Greece	그리스
Greek	그리스	그리스어	희랍
Green Party	녹색당
Greenberg	그린버그
Greenland	그린란드	그린랜드
Greenpeace	그린피스
Greenspan	그린스펀
Greenville	그린빌
Greenway	그린웨이
Greenwich	그리니치
Greenwood	그린우드
Greer	그리어
Greg	그레그	그렉
Gregorio	그레고리오
Gregory	그레고리
Grendel	그렌델
Greta	그레타
Gretchen	그레첸
Griff	그리프
Griffith	그리피스
Grigory	그리고리
Grimes	그라임스	그라임즈
Grint	그린트
Grozny	그로즈니
Guadalajara	과달라하라
Guam	괌
Guan Yu	관우
Guangdong	광동	광둥
Guangzhou	광저우	광주
Guantanamo	관타나모
Guatemala	과테말라
Guell	구엘
Guevara	게바라
Guggenheim	구겐하임
Guillaume	기욤
Guinea	기니
Guinness	기네스
Guizhou	구이저우
Gulliver	걸리버
Gumi	구미
Gump	검프
Gunpo	군포
Gunsan	군산
Gurkha	구르카
Guro	구로
Gustav	구스타브	구스타프
Gustavo	구스타보
Gutenberg	구텐베르크
Gutierrez	구티에레스
Gwacheon	과천
Gwanggaeto	광개토
Gwanghwamun	광화문
Gwangju	광주
Gwangyang	광양
Gwen	그웬
Gyanendra	갸넨드라
Gyeongbokgung	경복궁
Gyeongpodae	경포대
Gyeongsan	경산
HP
Haas	하스
Habib	하비브
Hackett	해켓
Hades	하데스
Hadley	해들리
Hadong	하동
Haenam	해남
Haeundae	해운대
Hagel	하겔
Hague	헤이그
Haier	하이얼
Haifa	하이파
Hainan	하이난
Haiphong	하이퐁
Haitai	해태
Haiti	아이티
Haiyan	하이옌
Hakata	하카타
Hakim	하킴
Haksan	학산
Haley	헤일리
Halifax	핼리팩스
Halla	한라
Halle	할레
Halle Berry	할리 베리
Hallelujah	할렐루야
Halley	핼리
Hamas	하마스
Hamburg	함부르크
Hamed	하메드
Hamel	하멜
Hamid	하미드
Hamilton	해밀턴	해밀튼
Hamlet	햄릿
Hammurabi	함무라비
Hampshire	햄프셔
Hampton	햄튼	햄프턴
Han Chinese	한족
Han River	한강
Hanako	하나코
Hanam	하남
Hanaro Telecom	하나로 텔레콤	하나로 통신
Hanbit	한빛
Hanbo	한보
Hancock	핸콕
Hancom	한컴
Hancom Linux	한컴 리눅스
Handel	헨델
Haneda	하네다
Hangame	한게임
Hangzhou	항저우
Hanjin	한진
Hank	행크
Hanks	행크스
Hankyoreh	한겨레
Hannet	한네트
Hannibal	한니발
Hanoi	하노이
Hans	한스
Hansel	헨젤
Hansen	한센
Hanshin	한신
Hansol	한솔
Hansol Paper	한솔 제지
Hanson	한슨	핸슨
Hansong	한송
Hanssem	한샘
Hansung	한성
Hanukkah	하누카
Hanwha	한화
Hanyang	한양
Hanyang University	한양대
Harbin	하얼빈
Hardy	하디
Hargreaves	하그리브스
Hariri	하리리
Harkin	하킨
Harlem	할렘
Harley	할리
Harmon	하몬
Harold	해럴드	해롤드
Harper	하퍼
Harriet	해리엇
Harrington	해링턴
Harris	해리스	헤리스
Harrisburg	해리스버그
Harrison	해리슨
Harry	해리	헤리
Harry Potter	해리 포터	헤리 포터
Hartley	하틀리
Haruki	하루키
Harvard	하바드	하버드
Harvard University	하버드대
Harvey	하비
Hashimoto	하시모토
Hassan	하산
Hastings	헤이스팅스
Hathaway	해서웨이	헤서웨이
Hatoyama	하토야마
Hatshepsut	하트셉수트
Hatta	하타
Hatton	해튼
Havana	아바나	하바나
Havel	하벨
Hawaii	하와이
Hawking	호킹
Hawkins	호킨스
Hayao	하야오
Hayashi	하야시
Hayden	헤이든
Haydn	하이든
Hayes	헤이스
Haynes	헤인즈
Hayward	헤이워드
Haywood	헤이우드
Headley	헤들리
Healey	힐리
Hearst	허스트
Heather	헤더
Hebei	허베이
Hebrew	히브리
Hebron	헤브론
Hector	헥터	헥토르
Hee	희
Heesung	희성
Hefner	헤프너
Hegel	헤겔
Heidelberg	하이델베르크
Heidi	하이디
Heifetz	하이페츠
Heine	하이네
Heinrich	하인리히
Heinz	하인즈	하인츠
Heisenberg	하이젠베르크
Helen	헬렌
Helena	헬레나
Helios	헬리오스
Heller	헬러
Hello Kitty	헬로 키티
Helmand	헬만드
Helmut	헬무트
Helsinki	헬싱키
Hemingway	헤밍웨이
Henan	허난
Henderson	핸더슨	헨더슨
Hendrix	헨드릭스
Henna	헤나
Hennessy	헤네시
Henry	앙리	헨리
Henson	헨슨
Heo Jun	허준
Heparin	헤파린
Hepburn	햅번	헵번
Hephaestus	헤파이스토스
Hera	헤라
Herald	헤럴드
Herbert	허버트
Hercules	허큘리스	헤라클레스
Herman	허만	허먼
Hermann	헤르만
Hermes	에르메스	헤르메스
Hermione	헤르미온느
Hernan	에르난
Hernandez	에르난데스	헤르난데스	헤르난데즈
Herod	헤롯
Heron	헤론
Herring	헤링
Hershey	허쉬	허시
Herzegovina	헤르체고비나
Heskey	헤스키
Hess	헤스
Hesse	헤세
Hester	헤스터
Heston	헤스턴
Heungnam	흥남
Hewitt	휴이트	휴잇
Hewlett	휴렛
Hibiya	히비야
Hickey	히키
Hicks	힉스
Hiddink	히딩크
Hideki	히데키
Hideo	히데오
Hideyoshi	히데요시
Higgins	히긴스
Highland	하이랜드
Hikari	히카리
Hikaru	히카루
Hillary	힐러리
Hilton	힐튼
Himalayas	히말라야
Hindenburg	힌덴부르크
Hingis	힝기스
Hippocrates	히포크라테스
Hirai	히라이
Hiro	히로
Hirohito	히로히토
Hiroki	히로키
Hiroko	히로코
Hirose	히로세
Hiroshi	히로시
Hiroshima	히로시마
Hisashi	히사시
Hispanic	히스패닉
Hitachi	히타치
Hitchcock	히치콕
Hitel	하이텔
Hitler	히틀러
Ho Chi Minh	호치민
Hobbs	홉스
Hobson	홉슨
Hodge	호지
Hodgkin	호지킨
Hodgson	호지슨
Hoffman	호프만	호프먼
Hogan	호건
Hogs	혹스
Hogwarts	호그와트
Hokkaido	홋카이도	훗카이도
Holden	홀덴	홀든
Holland	네덜란드	홀란드	홀랜드
Hollande	올랑드
Hollis	홀리스
Holloway	할로웨이
Holly	홀리
Hollywood	할리우드	헐리우드
Holmes	홈스	홈즈
Holt	홀트
Home Depot	홈디포
Homer	호머	호메로스
Honam	호남
Honda	혼다
Honduras	온두라스
Hong	홍
Hong Kong	홍콩
Hongdae	홍대
Honolulu	호놀룰루
Honshu	혼슈
Hoover	후버
Hopkins	홉킨스
Hopper	호퍼
Hormuz	호르무즈
Horowitz	호로위츠
Horta	오르타
Hoseo	호서
Hoskins	호스킨스
Hosokawa	호소카와
Houston	휴스턴	휴스톤
Howard	하워드
Howe	하우
Howell	하웰
Hoya	호야
Hu Jintao	후진타오
Huang	후앙
Hubbard	허바드	허버드
Hubble	허블
Hubei	후베이
Hubert	휴버트
Huck	허크
Huckabee	허커비
Hudson	허드슨
Hudson River	허드슨 강
Huerta	후에르타
Huff	허프
Huffington	허핑턴
Hughes	휴스
Hugo	우고	위고	휴고
Huizhou	후이저우
Hulk	헐크
Humancom	휴먼컴
Humax	휴맥스
Humboldt	험볼트	훔볼트
Hume	흄
Humphrey	험프리
Hun	훈
Hunan	후난
Hungarian	헝가리
Hungary	헝가리
Huntington	헌팅턴
Hurd	허드
Hurley	헐리
Hussein	후세인
Hutchins	허친스	헛친슨
Hutchinson	허친슨
Hutchison	허치슨
Hutton	허튼
Huxley	헉슬리
Huygens	호이겐스
Hwasun	화순
Hyatt	하얏트
Hyde	하이드
Hyderabad	하이데라바드
Hydra	히드라
Hyehwa	혜화
Hynix	하이닉스
Hynix Semiconductor	하이닉스	하이닉스 반도체
Hyojong	효종
Hyosung	효성
Hyperion	하이페리온
Hyun Bin	현빈
Hyundai	현대
Hyundai Asan	현대 아산
Hyundai Capital	현대 캐피탈
Hyundai Home Shopping	현대 홈 쇼핑
Hyundai Metal	현대 금속
Hyundai Mobis	현대 모비스
Hyundai Motor	현대	현대 자동차	현대차
Hyundai Securities	현대 증권
IBM	IBM	아이비엠
IKEA	이케아
Iago	이아고
Ian	이안	이언
Iberia	이베리아
Ibrahim	이브라힘
Ibrahimovic	이브라히모비치
Ibsen	입센
Icahn	아이칸
Icarus	이카루스
Iceland	아이슬란드
Icheon	이천
Ichiro	이치로
Idaho	아이다호
Idris	이드리스
Ieyasu	이에야스
Igor	이고르
Ike	아이크
Ikebana	이케바나
Ikeda	이케다
Iksan	익산
Ilbin Lee	이일빈
Iliad	일리아드
Iljin	일진
Illich	일리치
Illinois	일리노이
Immanuel	임마누엘
Imus	아이머스
Inca	잉카
Incheon	인천
Incredibles	인크레더블
Independence Day	독립기념일
India	인도	인디아	인디안	인디언
Indian Ocean	인도양
Indiana	인디아나	인디애나
Indianapolis	인디애나폴리스
Indira	인디라
Indonesia	인니	인도네시아
Indra	인드라
Indus	인더스
Infinity	인피니티
Infosec	인포섹
Infosys	인포시스
Ingrid	잉그리드
Initech	이니텍
Inner Mongolia	내몽고
Innsbruck	인스부르크
Inoue	이노우에
Intel	인텔
Intercom	인터컴
International Monetary Fund	IMF	국제통화기금
Internet	인터넷
Interpol	인터폴
Inuit	이누이트
Iowa	아이오와
Ipswich	입스위치
Iran	이란
Iraq	이라크
Ireland	아일랜드
Irene	아이린
Irish	아일랜드
Irkutsk	이르쿠츠크
Irvine	어바인
Irving	어빙
Irwin	어윈
Isaac	아이삭	아이작
Isabel	이사벨
Isabella	이사벨라
Isaiah	이사야
Isfahan	이스파한
Ishihara	이시하라
Ishikawa	이시카와
Isis
Islamabad	이슬라마바드
Ismael	이스마엘
Israel	이스라엘
Istanbul	이스탄불
Itaewon	이태원
Italian	이탈리	이탈리아	이태리
Italy	이탈리	이탈리아	이태리
Ithaca	이타카
Ito	이토
Ivan	이반
Ivanov	이바노프
Ivanovic	이바노비치
Iverson	아이버슨
Ivory Coast	코트디부아르
Izmir	이즈미르
Jackal	자칼
Jackie	재키	잭키
Jackie Chan	성룡
Jackman	잭맨
Jackson	잭슨	젝슨
Jacksonville	잭슨빌
Jacob	야곱	제이콥
Jacobs	제이콥스
Jacobson	제이콥슨
Jacoby	자코비
Jacqueline	재클린
Jacques	자크	쟈크
Jade	제이드
Jaffna	자프나
Jagalchi	자갈치
Jagger	재거
Jaipur	자이푸르
Jakarta	자카르타
Jake	제이크
Jalal	잘랄
Jamaica	자메이카
Jamal	자말
James	제임스	제임즈
Jameson	제임슨
Jamestown	제임스타운
Jamie	제이미
Jan	1월	잰
Jane	제인
Janes	제인스
Janet	자넷	재닛	쟈넷
Jangsaengpo	장생포
Janice	재니스	제니스
Jankovic	얀코비치
Janssen	얀센
Janus	야누스
Japan	일	일본	재팬	저팬
Japanese	일	일본	일본어	일본인	일어	일제
Jared	자렛	제러드
Jarvis	자비스
Jason	제이슨
Jasper	재스퍼	제스퍼
Java	자바
Java Island	자바 섬
Javad	자바드
Javed	자베드
Javier	하비에르
Jawad	자와드
Jazeera	자지라
Jean	장	쟝	진
Jeb	젭
Jecheon	제천
Jed	제드
Jeddah	제다
Jedi	제다이
Jeff	제프
Jefferson	제퍼슨
Jeffrey	제프리
Jeffreys	제프리스
Jeffs	제프스
Jehovah	여호와
Jeju	제주
Jeju Island	제주	제주도
Jemulpo	제물포
Jenkins	젠킨스
Jennifer	제니퍼
Jennings	제닝스
Jensen	젠센	젠슨
Jeolla	전라
Jeongeup	정읍
Jeongseon	정선
Jeonju	전주
Jeremiah	예레미아
Jeremy	제레미
Jericho	예리코	제리코
Jerome	제롬
Jerry	제리
Jerusalem	예루살렘
Jess	제스
Jessica	제시카
Jesuit	예수회
Ji Hoon	지훈
Ji Young	지영
Jiang Zemin	장쩌민
Jiangsu	장쑤
Jimmy	지미
Jinah	진아
Jincheon	진천
Jinhae	진해
Jinho	진호
Joan	조안
Joanna	조안나
Joanne	조앤
Joao	주앙
Joaquin	호아킨
Jodie	조디
Joel	조엘
Johannes	요하네스
Johannesburg	요하네스버그
Johansson	요한슨
John	요한	존	죤
John Smith	존 스미스
Johnny	쟈니	조니	죠니
Johnson	존슨	죤슨
Johnston	존스턴
Jonah	요나
Jonas	조나스
Jonathan	조나단	조너선
Jones	존스	존즈
Jongmyo Shrine	종묘
JoongAng Ilbo	중앙일보
Joplin	조플린
Jordan	요르단	조단	조던
Jorge	호르헤
Jose	호세
Joseon	조선
Joseph	요셉	요제프	조세프	조셉	조지프	죠셉
Josephine	조세핀
Josh	조쉬	조시
Joshua	조슈아
Joss	조스
Jowell	조웰
Joyce	조이스
Juan	후안
Judah	유다
Judd	저드
Jude	주드	쥬드
Judith	주디스	쥬디스
Judy	주디	쥬디
Julia	줄리아
Julian	줄리안	줄리언	쥴리안	훌리안
Julie	줄리	쥴리
Julien	줄리앙
Juliet	줄리엣
Julio	줄리오	훌리오
Julius	율리우스	줄리어스
Jumong	주몽
Jun Ho	준호
June	6월	준
Jung	융	정
Jungle Book	정글북
Junichi	주니치
Junichiro	준이치로
Junko	준코
Juno	주노
Jupiter	목성	주피터	쥬피터
Justice Department	법무부	사법부
Justice Party	정의당
Justin	저스틴
KBS
KEPCO	KEPCO	한국전력	한전
KINTEX	킨텍스
Kabul	카불
Kafka	카프카
Kagan	케이건
Kagoshima	가고시마
Kaiser	카이저
Kaka	카카
KakaoTalk	카카오톡
Kalashnikov	칼라시니코프
Kale	케일
Kamal	카말
Kamikaze	가미카제
Kandahar	칸다하르
Kandinsky	칸딘스키
Kane	케인
Kangwon Land	강원 랜드
Kansai	간사이
Kansas	캔자스
Kant	칸트
Kanto	관동
Kanye	카니예
Kaplan	카플란
Kapur	카푸르
Kara	카라
Karachi	카라치
Karajan	카라얀
Karamazov	카라마조프
Karbala	카르발라
Kardashian	카다시안
Karel	카렐
Karen	카렌	카렌족	캐런	케런
Karim	카림
Karimov	카리모프
Karnataka	카르나타카
Karzai	카르자이
Kashmir	카슈미르
Kasparov	카스파로프
Katanga	카탕가
Kate	케이트
Katherine	캐더린
Kathleen	캐슬린
Kathmandu	카트만두
Katia	카티아
Katie	케이티
Katrina	카트리나
Katz	카츠
Kaufman	카우프만
Kawasaki	가와사키
Kazakh	카자흐
Kazakhstan	카자흐스탄
Kazan	카잔
Kazuo	가즈오
Keanu	키아누
Keating	키팅
Keaton	키튼
Kedcom	케드콤
Keiko	케이코
Keio	게이오
Keith	키이스
Kelantan	켈란탄
Keller	켈러
Kellogg	켈로그
Kelly	켈리
Kelsey	켈시
Kelvin	켈빈
Kemp	켐프
Ken	켄
Kendall	켄달
Kendra	켄드라
Kendrick	켄드릭
Kenji	겐지	켄지
Kennedy	케네디
Kenneth	케네스
Kenny	케니
Kent	켄트
Kentucky	켄터키
Kenya	케냐
Kenyatta	케냐타
Kepler	케플러
Kerala	케랄라
Kerry	케리
Kessler	케슬러
Kevin	케빈
Key West	키웨스트
Keynes	케인스	케인즈
Keystone	키스톤
Khaled	칼레드
Khalid	칼리드
Khalil	칼릴
Khartoum	하르툼
Khmer	크메르
Khomeini	호메이니
Khrushchev	흐루시초프
Kia	기아
Kibera	키베라
Kidman	키드먼
Kidzania	키자니아
Kiev	키에브	키예프
Kikuchi	키쿠치
Kilimanjaro	킬리만자로
Kim	김	킴
Kim Hoon	김훈
Kim Il	김일
Kim Jin	김진
Kim Jong Il	김 국방위원장	김정일
Kim Jong Un	김 위원장	김정은
Kim Jong-il	김 국방위원장	김정일
Kim Jong-un	김 위원장	김정은
Kimberly	킴벌리
Kimura	기무라
Kinder	킨더
King Kong	킹콩
King Sukjong	숙종
Kingsley	킹슬리
Kingston	킹스턴	킹스톤
Kinsey	킨지
Kipling	키플링
Kiribati	키리바시
Kirk	커크
Kirkuk	키르쿠크	키리쿠크
Kirov	키로프
Kissinger	키신저
Kisumu	키수무
Klaus	클라우스
Klein	클라인
Klimt	클림트
Klose	클로제	클로즈
Knightley	나이틀리
Knox	녹스
Knoxville	녹스빌
Knut	크누트
Kobayashi	고바야시	코바야시
Kobe	고베	코베	코비
Koch	코흐
Kocom	코콤
Kodak	코닥
Kodicom	코디콤
Koichi	고이치	코이치
Koirala	코이랄라
Koizumi	고이즈미
Kolkata	콜카타
Kolon	코오롱
Komodo	코모도
Konkuk University	건국대
Kookmin Bank	KB	국민 은행
Kookmin Card	국민 카드
Koran	코란
Korea	고려	대한민국	코리아	코리언	한	한국
Korea Advanced Institute of Science Technology	KAIST	카이스트
Korea Development Institute	한국 개발 연구원
Korea Football Association	KFA	대한 축구 협회
Korea Telecom	KT	한국 통신
Korea University	고려대
Korean Air	대한 항공
Korean Peninsula	조선 반도	한반도
Korean War	625	한국 전쟁
Kosovo	코소보
Kowalski	코왈스키
Kowloon	구룡
Kowloon Peninsula	구룡 반도
Krakow	크라쿠프
Kramer	크레이머
Krauss	크라우스
Kremlin	크렘린
Krishna	크리슈나
Kruger	크루거
Krugman	크루그먼
Kuala Lumpur	콸라룸푸르	쿠알라룸푸르
Kublai	쿠빌라이
Kubrick	큐브릭
Kuiper	카이퍼
Kumar	쿠마	쿠마르
Kumari	쿠마리
Kumho	금호
Kunming	쿤밍
Kunshan	쿤산
Kuramoto	구라모토
Kurdish	쿠르드
Kurds	쿠르드족
Kurt	쿠르트
Kurtz	커츠
Kurzweil	커즈와일
Kuwait	쿠웨이트
Kuyt	카윗
Kwak	곽
Kyle	카일
Kylie	카일리
Kyobo	교보
Kyoto	교토
Kyrgyzstan	키르기스스탄
Kyungdong	경동
Kyunghee	경희
Kyunghee University	경희대
Kyungmin	경민
Kyushu	규슈	큐슈
LAN	LAN	랜
LCD TV
LG	LG	엘지
LG CNS
LG Electronics	LG	LG 전자
LG Philips LCD	LG 필립스 LCD
LG Telecom	LGT	LG텔레콤
LaGuardia	라과디아
Labrador	래브라도
Lacey	레이시
Laden	라덴
Lafayette	라파예트
Lagos	라고스
Lahore	라호르
Lake Baikal	바이칼 호
Lakota	라코타
Lamar	라마르
Lambda	람다
Lambert	램버트
Lamborghini	람보르기니
Lamont	라몬트
Lampard	램퍼드
Lana	라나
Lancashire	랭커셔
Lancaster	랭커스터
Lance	랜스
Landers	랜더스
Landis	랜디스
Landon	랜던
Landry	랜드리
Lang	랭
Langdon	랭던
Langley	랭글리
Langston	랭스턴
Lanza	란자
Lao Tzu	노자
Laos	라오스
Laramie	라라미
Larkin	라킨
Larry	래리	레리
Larry King	래리 킹
Larson	라슨
Larsson	라르손
Las Vegas	라스 베가스	라스 베이거스
Latch	래치
Latif	라티프
Latin	라틴
Latin America	라틴 아메리카	중남미
Latte	라떼	라테
Latvia	라트비아
Laura	라우라	로라
Laurel	로렐
Lauren	로렌
Laurent	로랑
Laursen	라우르센
Lausanne	로잔
Lavigne	라빈
Lavinia	라비니아
Lawrence	로렌스
Lawson	로슨
Lazio	라치오
Le Monde	르 몽드
Leandro	레안드로
Lebanon	레바논
Lebron	르브론
Lech	레흐
Lecter	렉터
Lee Dae Ho	이대호
Lee Hwang	이황
Lee Hyo Ri	이효리
Lee Min Ho	이민호
Lee Myung Bak	이명박
Lee Seung Gi	이승기
Leeds	리즈
Legato	레가토
Legolas	레골라스
Lehman	레만	리만	리먼
Leibniz	라이프니츠
Leica	라이카
Leicester	레스터
Leighton	레이튼
Leipzig	라이프치히
Lena	레나
Lenin	레닌
Leningrad	레닌그라드
Lennon	레넌	레논
Lenny	레니
Leno	레노
Lenovo	레노버
Leo	레오
Leon	레온	레옹
Leona	레오나
Leonard	레너드	레오나드
Leonardo	레오나르도
Leonid	레오니드
Leonidas	레오니다스
Leopold	레오폴드	레오폴트
Les Miserables	레미제라블
Leslie	레슬리
Lesotho	레소토
Letterman	레터맨
Lev	레프
Leverkusen	레버쿠젠
Levi	리바이
Levin	레빈
Levinson	레빈슨
Levitt	레빗
Lewinsky	르윈스키
Lexington	렉싱턴
Lexy	렉시
Lhasa	라싸
Liam	리암	리엄
Liaoning	랴오닝
Libby	리비
Liberal Party	자유당
Liberia	라이베리아
Libya	리비아
Liechtenstein	리히텐슈타인
Liger	라이거
Lily	릴리	백합
Lima	리마
Lincoln	링컨
Lincoln Center	링컨센터
Lincolnshire	링컨셔
Lind	린드
Linda	린다
Lindbergh	린드버그
Linden	린든
Lindo	린도
Lindsay	린제이	린지
Lineker	리네커
Linkin	린킨
Linton	린튼
Linus	라이너스
Linz	린즈
Lionel	라이오넬	리오넬
Lipton	립톤
Lisa	리사	리자
Lisbon	리스본
Lithuania	리투아니아
Livermore	리버모어
Liverpool	리버풀
Living Net	리빙넷
Livingstone	리빙스턴	리빙스톤
Livni	리브니
Lizzie	리지
Lloyd	로이드
Loch Ness	네스 호
Lockhart	록하트
Lockheed	록히드
Locus	로커스
Logan	로건
Logitech	로지텍
Loire	루아르	루와르
Lolita	로리타
Lombard	롬바르드
London	런던
Lone Star	론 스타
Long Beach	롱 비치
Longman	롱맨
Longoria	롱고리아
Lopez	로페스	로페즈
Lorena	로레나
Lorenzo	로렌조
Loretta	로레타
Lori	로리
Lorin	로린
Lorraine	로레인
Los Angeles	LA	로스 앤젤레스	로스 엔젤러스	로스 엔젤레스
Lotte	롯데
Lotte Card	롯데 카드
Lotte Cinema	롯데 시네마
Lotte Confectionery	롯데 제과
Lotte Electronics	롯데 전자
Lotte Hotel	롯데 호텔
Lotte Mart	롯데 마트
Lotte World	롯데 월드
Lou Gehrig	루게릭
Louis	루이	루이스
Louis Vuitton	루이 비통
Louisa	루이자
Louise	루이즈
Louisiana	루이지애나
Louisville	루이빌
Lourdes	루르드
Louvre	루브르
Lowell	로웰
Loyola	로욜라
Lu Xun	루쉰
Luc	뤽
Luca	루카
Lucas	루카스
Lucerne	루체른
Lucia	루시아	루치아
Lucian	루시안
Luciano	루치아노
Lucifer	루시퍼
Lucy	루시
Ludwig	루드비히	루트비히
Lufthansa	루프트한자
Luigi	루이지
Luke	루크
Lula	룰라
Lulu	루루
Luna	루나
Luo	루오
Luoyang	낙양
Luther	루터
Luton	루턴
Luxembourg	룩셈부르크
Luxor	룩소르
Lycos	라이코스
Lydia	리디아
Lyle	라일
Lynch	린치
Lyon	리옹	리용
MBC	MBC	문화방송
Maasai	마사이족
Mabinogi	마비노기
MacArthur	맥아더
MacGyver	맥가이버
Macau	마카오
Macbeth	맥베스
Macedonia	마케도니아
Machiavelli	마키아벨리
Machu Picchu	마추픽추
Macintosh	맥킨토시
Mackay	맥케이
Mackenzie	매켄지	맥켄지
Macmillan	맥밀란
Macquarie	맥쿼리
Macy	메이시
Madagascar	마다가스카	마다가스카르
Madden	매든
Maddox	매덕스
Madeira	마데이라
Madeleine	마들렌
Madison	매디슨	메디슨
Madoff	매도프
Madonna	마돈나
Madrid	마드리드
Maeda	마에다
Magdalene	막달라
Magellan	마젤란
Maghreb	마그레브
Magna Chip	매그나칩
Magritte	마그리트
Maguire	맥과이어
Mahathir	마하티르
Mahatma	마하트마
Mahinda	마힌다
Mahler	말러
Mahmoud	마무드	마흐무드
Mailer	메일러
Maine	메인주
Mainichi	마이니치
Mainz	마인츠
Majid	마지드
Major League	메이저 리그
Makati	마카티
Maki	마키
Makoto	마코토
Malacca	말라카
Malawi	말라위
Malay	말레이
Malaysia	말레이시아	말레이지아
Malcolm	말콤
Maldini	말디니
Mali	말리
Malibu	말리부
Malik	말리크
Mallorca	마요르카
Malone	말론
Malt	몰트
Malta	몰타
Malthus	맬서스
Mamoru	마모루
Manchester	맨체스터
Manchester United	맨체스터	맨체스터 유나이티드
Mandalay	만달레이
Mandarin	만다린
Mandela	만델라
Mando	만도
Mandy	맨디
Manet	마네
Manhae	만해
Manhattan	맨하탄	맨해튼
Manila	마닐라
Manning	매닝
Manny	매니
Mansfield	맨스필드
Manson	맨슨
Mantovani	만토바니
Manuel	마누엘	마뉴엘
Mao	마오
Mao Zedong	마오쩌둥
Maori	마오리	마오리족
Maple	메이플
Mapo	마포
Mara	마라
Marado	마라도
Maradona	마라도나
Marcel	마르셀
Marche	마르케
Marco	마르코
Marco Polo	마르코 폴로
Marconi	마르코니
Marcos	마르코스
Marcus	마르커스	마커스
Marduk	마르두크
Margaret	마가렛	마거릿
Margot	마고
Maria	마리아
Mariah	머라이어
Marianne	마리안느
Mariano	마리아노
Marie	마리
Mariko	마리코
Marilyn	마릴린	매릴린	메릴린
Marino	마리노
Mario	마리오
Marion	마리온	매리언
Maris	마리스
Marissa	마리사
Marius	마리우스
Marjorie	마조리
Markus	마르쿠스
Marlins	말린스
Marlowe	말로우
Marrakesh	마라케시
Marriott	매리어트	매리엇	메리어트	메리엇
Mars	마르스	마스	마즈	화성
Marseille	마르세유	마르세이유
Marsh	마쉬
Marshall	마샬	마셜
Martel	마르텔
Martha	마르타	마사
Martin	마르탱	마르틴	마틴
Martin Luther King	마틴 루터 킹
Martina	마르티나
Martinez	마르티네스	마르티네즈	마티네즈
Martinique	마르티니크
Martins	마틴스
Marty	마티
Marvin	마빈
Marx	마르크스
Mary	매리	메리	메어리
Maryland	메릴랜드
Masahiko	마사히코
Masai	마사이
Masaki	마사키
Masako	마사코
Masan	마산
Masao	마사오
Masaru	마사루
Maserati	마세라티
Mason	메이슨
Massachusetts	매사추세츠
Massimo	마시모
Mata	마타
Mateo	마테오	마티오
Mathieu	마티유
Matilda	마틸다
Matisse	마티스
Matsui	마쓰이
Matsumoto	마츠모토
Matsuoka	마츠오카
Matsushita	마쓰시타
Matt	매트	맷
Mattel	마텔
Matterhorn	마터호른
Matthew	마태	마태복음	매튜	메튜
Matthews	매튜스
Maui Island	마우이 섬
Maureen	모린
Mauritius	모리셔스
Maverick	매버릭
Max	막스	맥스
Maxim	맥심
Maxwell	맥스웰
Maya	마야
Mayer	메이어
Mayfield	메이필드
Mayflower	메이플라워
Mayo	마요	메이요
Mayweather	메이웨더
Mazda	마쓰다	마즈다
Mbeki	음베키
McAfee	맥아피
McBride	맥브라이드
McCain	매케인	메케인
McCarthy	매카시	맥카시
McCartney	매카트니	맥카트니
McCarty	맥카티
McConaughey	맥커너히
McConnell	맥코넬
McCormack	매코맥	맥코맥
McCoy	맥코이
McCurry	맥커리
McDonnell	맥도넬
McDonough	맥도너	맥도노프
McDowell	맥도웰
McGill	맥길
McGovern	맥거번
McGregor	맥그레거	맥그리거
McHenry	맥헨리
McKinley	매킨리	맥킨리
McKinsey	맥킨지
McLean	맥린
McLuhan	맥루한
McMahon	맥마흔
McMaster	맥마스터
McNamara	맥나마라
McPherson	맥퍼슨
Mcadams	맥아담스
Mecca	메카
Medea	메데아
Medici	메디치	메디치가
Medina	메디나
Mediterranean	지중해
Medvedev	메드베데프
Meg	메그	멕
Megan	메건
Megatron	메가트론
Megumi	메구미
Mehdi	메흐디
Meiji	메이지
Meister	마이스터
Mekong	메콩
Mekong River	메콩 강
Mel	멜
Melanie	멜라니
Melbourne	멜버른
Melinda	멜린다
Melville	멜빌
Melvin	멜빈
Memphis	멤피스
Mencius	맹자
Mendel	멘델
Mendeleev	멘델레예프
Mendelson	멘델슨
Mendelssohn	멘델스존
Mendes	멘데스
Mendez	멘데즈
Menendez	메넨데즈
Menzies	멘지스
Meo	메오
Mercedes	메르세데스
Mercedes Benz	메르세데스 벤츠	벤즈
Mercer	머서
Merck	머크
Mercury	머큐리	수성	수은
Meredith	메러디스	메레디스
Merkel	메르켈
Merlin	멀린
Merrill Lynch	메릴린치
Mers	메르스
Merseyside	머지사이드
Merton	머튼
Meryl	메릴
Mesopotamia	메소포타미아
Messina	메시나
Meta	메타
Metallica	메탈리카
Mets	메츠
Mexican	멕시칸	멕시컨	멕시코
Mexico	멕시코
Mexico City	멕시코 시티
Meyer	마이어
Meyers	메이어스
Mia	미아
Miami	마이애미
Michael	마이클	미카엘	미하엘
Michael Jackson	마이클 잭슨
Michelangelo	미켈란젤로
Michelin	미슐랭
Michelle	미셸	미쉘
Michigan	미시간 미시건
Michiko	미치코
Mickey	미키
Middle East	중동
Middlesbrough	미들즈브러
Middleton	미들턴	미들튼
Midland	미들랜드
Midori	미도리
Midtown	미드타운
Mignon	미뇽
Miguel	미겔	미구엘
Mikel	미켈
Mikey	마이키
Mikhail	미하일
Mila	밀라
Milan	밀라노	밀란
Mildred	밀드레드
Milford	밀포드
Miller	밀러
Millet	밀렛
Milton	밀턴	밀튼
Milwaukee	밀워키
Mimi	미미
Min	민 분
Minami	미나미
Minato	미나토
Mindanao	민다나오
Mindy	민디
Minerva	미네르바
Ming	명	밍
Minji	민지
Minneapolis	미니애폴리스
Minnesota	미네소타
Minogue	미노그
Minoru	미노루
Minos	미노스
Mir	미르
Miranda	미란다
Miriam	미리암	미리엄
Mirren	미렌
Mishima	미시마
Miss Korea	미스 코리아
Mississippi	미시시피
Mississippi River	미시시피 강
Missouri	미주리
Mitch	밋치
Mitchell	미첼	밋첼
Mito	미토
Mitsui	미쓰이
Miura	미우라
Miyagi	미야기
Miyamoto	미야모토
Miyazaki	미야자키
Mizuno	미즈노
Mobis	모비스
Mobius	뫼비우스
Moby	모비
Mococo	모코코
Modena	모데나
Mohammad	모하마드
Mohammed	모하메드
Mohawk	모호크
Mohican	모히칸
Mokpo	목포
Moldova	몰도바
Molina	몰리나
Molly	몰리
Mombasa	몸바사
Mona	모나
Mona Lisa	모나리자
Monaco	모나코
Monarch	모나크
Monday	월	월요일
Monde	몽드
Mondrian	몬드리안
Monet	모네
Moneta	모네타
Mongolia	몽고	몽골
Monica	모니카
Mono	모노
Monroe	먼로	몬로
Monsanto	몬산토
Mont Blanc	몽블랑
Montaigne	몽테뉴
Montana	몬타나	몬태나
Monte	몬테
Monte Carlo	몬테카를로
Montenegro	몬테네그로
Monterey	몬터레이
Monterrey	몬테레이
Montes	몬테스
Montesquieu	몽테스키외
Montessori	몬테소리
Montgomery	몽고메리
Montoya	몬토야
Montreal	몬트리올
Monty	몬티
Moore	무어
Morales	모랄레스
Moreno	모레노
Morgan	모건	모르간
Mori	모리
Moriarty	모리아티
Morimoto	모리모토
Morita	모리타
Morocco	모로코
Morris	모리스
Morrison	모리슨
Morse	모스
Mort	모트
Moscow	모스코	모스크바
Moselle	모젤
Moses	모세
Mosley	모슬리
Mossad	모사드
Mosul	모술
Mourinho	무리뉴
Mozambique	모잠비크
Mozart	모짜르트	모차르트
Mubarak	무바라크
Mugabe	무가베
Mughal	무굴
Muhammad	무하마드	무함마드
Muir	뮤어
Muju	무주
Mulan	뮬란
Mulder	멀더
Muller	뮬러
Mumbai	뭄바이
Mummy	미라
Munich	뮌헨
Munsan	문산
Murakami	무라카미
Murano	무라노
Murata	무라타
Murdoch	머독
Muriel	뮤리엘
Murphy	머피
Murray	머레이
Musharraf	무샤라프
Musk	머스크
Mussolini	무솔리니
Mustafa	무스타파
Mustang	머스탱
Myanmar	미얀마
Mycenae	미케네
Myers	마이어스
Myron	마이런
Mystic	미스틱
N-SCTY Corporation
NAND	낸드
NASCAR	나스카
NASDAQ	나스닥
NATO	나토
Nachos	나초
Nadal	나달
Nader	네이더
Nadia	나디아
Nagano	나가노
Nagasaki	나가사키
Nagoya	나고야
Nairobi	나이로비
Najaf	나자프
Nakagawa	나카가와
Nakamura	나카무라
Nakano	나카노
Nakashima	나카시마
Nakasone	나카소네
Nakata	나카타
Nakdong River	낙동강
Nam River	남강
Namdaemun	남대문
Namdaemun Market	남대문 시장
Namgung	남궁
Nami Island	남이섬
Namibia	나미비아
Namo	나모
Namsan	남산
Namwon	남원
Namyang	남양
Namyang Dairy	남양 유업
Namyangju	남양주
Nancy	낸시
Nanjing	난징	남경
Naomi	나오미
Naoto	나오토
Napa	나파
Napoleon	나폴레온	나폴레옹
Napolitano	나폴리타노
Narcissus	나르시스
Nargis	나르기스
Narita	나리타
Naro	나로
Naruhito	나루히토
Nashville	내슈빌
Nasrallah	나스랄라
Nassau	나소
Nasser	나세르
Natal	나탈
Natalia	나탈리아
Natalie	나탈리
Natasha	나타샤
Nathan	네이선	네이슨
Nathaniel	나다니엘
National Assembly	국회	의회
National Security	국가 보안	국가 안보	국가 안전
Nauru	나우루
Nautilus	노틸러스
Navajo	나바호
Navarro	나바로
Naver	네이버
Nawaz	나와즈
Nazarbayev	나자르바예프
Nazareth	나사렛	나자렛
Nazi	나찌	나치
Nebraska	네브래스카
Ned	네드
Negroponte	네그로폰테
Nehru	네루
Neil	닐
Nell	넬
Nelson	넬슨
Nemo	니모
Nepal	네팔
Neptune	넵튠	해왕성
Nero	네로
Ness	네스
Nesta	네스타
Nestle	네슬레
Nestor	네스토르
Netanyahu	네타냐후
Netflix	넷플릭스
Netherlands	네덜란드
Netian	네띠앙
Netmarble	넷마블
Netpia	넷피아
Nets	네츠	넷츠
Netsgo	넷츠고
Nevada	네바다
Neville	네빌
New Caledonia	뉴칼레도니아
New Delhi	뉴델리
New England	뉴잉글랜드
New Guinea	뉴기니
New Hampshire	뉴햄프셔
New Jersey	뉴저지
New Mexico	뉴멕시코
New Orleans	뉴올리언스	뉴올리언즈
New Year	새해	설	설날	신년
New York	뉴욕
New York Times	뉴욕 타임스	뉴욕 타임즈
New Yorker	뉴요커
New Zealand	뉴질랜드
Newark	뉴어크
Newberry	뉴베리
Newcastle	뉴캐슬
Newfoundland	뉴 펀들랜드
Newman	뉴먼
Newport	뉴포트
Newt	뉴트
Newton	뉴턴	뉴톤	뉴튼
Nexen	넥센
Nexgen	넥스젠
Nexon	넥슨
Nextel	넥스텔
Nguyen	응우옌	응웬
Niagara	나이아가라
Nicaragua	니카라과
Nicholas	니콜라스
Nichols	니콜스
Nicholson	니콜슨
Nicky	닉키
Nicolaus	니콜라우스
Nicole	니콜
Niels	닐스
Nielsen	닐슨
Nietzsche	니체
Nigel	나이젤	니겔
Niger	니제르
Nigeria	나이지리아
Nihon	니혼
Niigata	니가타
Nike	나이키
Nikita	니키타
Nikkei	니케이	닛케이
Nikki	니키
Nikolay	니콜라이
Nile	나일
Nile River	나일 강
Nina	니나
Nineveh	니네베
Ningbo	닝보
Nino	니노
Nintendo	닌텐도
Niro	니로
Nirvana	너바나
Nissan	닛산
Nistelrooy	니스텔루이
Nita	니타
Nixon	닉슨
Noah	노아
Nobel	노벨
Nobel Peace Prize	노벨 평화상
Nobel Prize	노벨	노벨 상
Nobunaga	노부나가
Noel	노엘
Nokia	노키아
Nomura	노무라
Nongshim	농심
Nora	노라
Nordic	노르딕
Noriega	노리에가
Norma	노마
Norman	노르만	노만	노먼
Normandy	노르망디
Norris	노리스
North Africa	북 아프리카
North America	미국	북 아메리카	북미
North Carolina	노스 캐롤라이나
North Korea	북	북 조선	북한
North Pacific	북 태평양
North Pole	북극
North Sea	북해
North Vietnam	북 베트남
Northeast Asia	동북 아시아	동북아
Northern Ireland	북 아일랜드	아일랜드
Northwest	노스웨스트	북서
Norton	노턴	노튼
Norway	노르웨이
Norwich	노리치
Noryangjin	노량진
Nosamo	노사모
Nostradamus	노스트라다무스
Notre Dame	노트르담	노틀담
Notting Hill	노팅힐
Nottingham	노팅엄
Nova	노바
Nova Scotia	노바 스코샤
Novak	노박
Novosti	노보스티
Nowcom	나우콤
Nowitzki	노비츠키
Noyce	노이스
Nukaga	누카가
Nuremberg	뉘른베르크
Nuri	누리
OSRAM	오스람
Oakley	오클리
Oaxaca	오악사카
Oberon	오베론
Obi	오비
Obrador	오브라도르
Obuchi	오부치
Oceania	오세아니아
Ochoa	오초아
Octavia	옥타비아
Octavian	옥타비아누스
Oden	오든
Odin	오딘
Odori	오도리
Odysseus	오디세우스
Odyssey	오디세이	오딧세이
Oedipus	오이디푸스
Ohio	오하이오
Okada	오카다
Okapi	오카피
Okawa	오카와
Okinawa	오키나와
Oklahoma	오클라호마
Okubo	오쿠보
Okuda	오쿠다
Okura	오쿠라
Olaf	올라프
Old Testament	구약	구약성경	구약성서
Oldenburg	올덴버그
Oliver	올리버
Olivia	올리비아
Olivier	올리비에
Olmert	올메르트
Olsen	올슨
Olympia	올림피아
Olympic	올림픽
Olympus	올림푸스
Omaha	오마하
Omar	오마르
Omni	옴니
Omnitel	옴니텔
Omura	오무라
Ongamenet	온게임넷
Ono	오노
Ontario	온타리오
Onyang	온양
Oprah	오프라
Oracle	오라클
Oracle Korea	한국 오라클
Oregon	오레건	오리건
Oricon	오리콘
Orion	오리온
Orlando	올란도	올랜도
Orleans	올리언스
Orsay	오르세
Orson	오슨
Ortega	오르테가
Orville	오빌	올빌
Orwell	오웰
Osaka	오사카
Osama	오사마
Osamu	오사무
Osan	오산
Osborne	오스본
Oscar	오스카
Oshima	오시마
Oslo	오슬로
Oster	오스터
Oswald	오스왈드
Othello	오델로	오셀로
Otis	오티스
Ottawa	오타와
Ottogi	오뚜기
Ottoman	오스만
Oullim Information Technology	어울림 정보 기술
Outback	아웃백
Owen	오언	오웬
Owens	오웬스
Oxbridge	옥스브리지
Oxfam	옥스팜
Oxford	옥스퍼드	옥스포드
Oz	오즈
Ozawa	오자와
PDP TV
PM ET	PM ET	동부 시간 오후
POSCO	포스코
Pablo	파블로
Pacific	태평양	퍼시픽
Pacific Rim	환태평양
Pacino	파치노
Packard	팩커드
Packer	패커
Pacman	팩맨
Paddington	패딩턴
Paddy	패디
Paganini	파가니니
Pagoda	파고다
Paju	파주
Pakistan	파키스탄
Palau	팔라우
Palawan	팔라완
Palermo	팔레르모
Palin	페일린
Palm Springs	팜스프링스
Paltrow	팰트로
Pamela	파멜라
Pamplona	팜플로나
Panama	파나마
Panama City	파나마 시티
Panasonic	파나소닉
Pandora	판도라
Pangya	팡야
Pangyo	판교
Pantech	팬택
Pantheon	판테온
Paolo	파올로
Papa	파파
Papua	파푸아
Papua New Guinea	파푸아뉴기니
Paradise Hotel	파라다이스 호텔
Paraguay	파라과이
Pareto	파레토
Parfait	파르페
Paris	파리	파리스	패리스
Park Jin	박진
Park Shin Yang	박신양
Parker	파커
Parkinson	파키슨	파킨슨
Parma	파르마
Parry	패리
Parsons	파슨스
Parthenon	파르테논
Paso	파소
Pasteur	파스퇴르
Patagonia	파타고니아
Patel	파텔
Pathfinder	패스파인더
Patrice	파트리스	패트리스
Patricia	패트리샤
Patrick	패트릭	페트릭
Patsy	팻시
Patterson	패터슨
Pattinson	패틴슨
Patton	패튼
Patty	패티
Paul	바오로	바울	폴
Paula	파울라	폴라
Pauline	폴린
Paulo	파울로
Paulson	폴슨
Pavarotti	파바로티
Pavel	파벨
Pavlov	파블로프
Pavlyuchenko	파블류첸코
Paxnet	팍스넷
Paypal	페이팔
Peabody	피바디
Peacock	피콕
Pearl	진주	펄
Pearl Harbor	진주만
Pearson	피어슨
Pedro	페드로
Peggy	페기
Pele	펠레
Pelosi	펠로시
Pena	페나
Penang	페낭
Penelope	페넬로페
Pennsylvania	펜실베니아	펜실베이니아
Pepe	페페
Pepsi	펩시
PepsiCo	펩시코
Percy	퍼시
Pereira	페레이라
Perez	페레스	페레즈
Perino	페리노
Perkins	퍼킨스
Perlman	펄만	펄먼
Peron	페론
Persephone	페르세포네
Perseus	페르세우스
Persia	페르시아
Persian Gulf	페르시아 만
Peru	페루
Pervez	페르베즈
Peshawar	페샤와르
Peter	베드로	페터	페테르	피터
Peter Pan	피터 팬
Peters	피터스
Petersburg	상트페테르부르크	페테르부르크
Peterson	페터슨	피터슨
Petr	페트르
Petra	페트라
Petrella	페트렐라
Petri	페트리
Petronas	페트로나스
Petrov	페트로프
Peugeot	푸조
Pfizer	화이자
Pharaoh	파라오
Phelps	펠프스
Phicom	파이컴
Phil	필
Philadelphia	필라델피아
Philip	필립
Philippe	필리페	필리프
Philippines	필리핀
Philips	필립스
Phnom Penh	프놈펜
Phoenicia	페니키아
Phoenician	페니키아
Phoenix	봉황	피닉스
Phuket	푸켓
Piaget	피아제
Picasso	피카소
Piccadilly	피카딜리	피커딜리
Pickering	피커링
Pierce	피어스
Pierre	피에르
Pietro	피에트로
Pikachu	피카츄
Pike	파이크
Pilate	빌라도
Pina	피나	피냐
Pinatubo	피나투보
Pincus	핀커스
Pinocchio	피노키오
Pinochet	피노체트
Pinter	핀터
Piper	파이퍼
Pippin	피핀
Pisa	피사
Pisco	피스코
Pistol	피스톨
Pistols	피스톨즈
Pistorius	피스토리우스
Pita	피타
Pittsburgh	피츠버그
Pixar	픽사
Pizza Hut	피자헛
Plaza Hotel	플라자 호텔
Pleo	플레오
Pluto	명왕성	플루토
Plymouth	플리머스
Poe	포우
Pohang	포항
Poitras	포이트라스
Poland	폴란드	폴랜드
Polanski	폴란스키
Policewoman	여경
Pollard	폴라드
Pollock	폴락	폴록
Poly	폴리
Polynesia	폴리네시아
Polynesian	폴리네시안
Pompeii	폼페이
Poncho	판초
Pong	퐁
Ponte	폰테
Ponzi	폰지
Popeye	뽀빠이
Pororo	뽀로로
Porsche	포르셰	포르쉐
Port-au-Prince	포르토프랭스
Portland	포틀랜드
Portman	포트먼
Porto	포르토	포르투
Portsmouth	포츠머스
Portugal	포르투갈
Portuguese	포르투갈
Poseidon	포세이돈
Potemkin	포템킨
Potomac	포토맥
Potsdam	포츠담
Potts	포츠
Powell	파월	파웰	포웰
Powercom	파워콤
Prada	프라다
Prado	프라도
Prague	프라하
Prasad	프라사드
Pratt	프랫
Premier League	프리미어 리그
Prentice	프렌티스
Prescott	프레스콧
President Bush	부쉬	부시	부시 대통령
President George Bush	부쉬	부시	조지 부시 대통령
President George W. Bush	부쉬	부시	조지 W 부시 대통령
President Kim	김 대통령	김대중 대통령
President Lee	이 대통령	이명박 대통령
President Lee Myung-bak	이 대통령	이명박 대통령
President Obama	오바마	오바마 대통령
President Roh	노 대통령	노무현 대통령
President Roh Moo-hyun	노 대통령	노무현 대통령
Presley	프레슬리
Press Center	프레스 센터
Preston	프레스턴	프레스톤
Prime Minister	수상	총리
Princeton	프린스턴
Pringles	프링글스
Priscilla	프리실라
Pritchard	프리차드	프리처드
Prix	프리	프릭스
Progressive Party	진보당
Prometheus	프로메테우스
Proust	프루스트
Provence	프로방스
Providence	프로비던스
Proxy	프록시
Prudential	프루덴셜
Prussia	프러시아	프로이센
Psy	싸이
Psyche	정신	프시케
Ptolemy	프톨레마이오스
Puccini	푸치니
Pudong	푸둥
Pueblo	푸에블로
Puerta	푸에르타
Puerto	푸에르토
Puerto Rico	푸에르토 리코
Pulitzer	퓰리처
Puma	푸마
Punjab	펀자브
Purdue	퍼듀
Pushkin	푸시킨
Putin	푸틴
Puyol	푸욜
Pyeongchang	평창
Pyeongtaek	평택
Pygmalion	피그말리온
Pygmy	피그미
Pyongyang	평양
Pythagoras	피타고라스
Qala	콸라
Qantas	콴타스
Qing Dynasty	청
Qingdao	청도	칭다오	칭따오
Qinghai	칭하이
Quaker	퀘이커
Qualcomm	퀄컴
Quebec	퀘벡	퀘벡주
Queensland	퀸즐랜드
Quentin	쿠엔틴
Quidditch	퀴디치
Quincy	퀸시
Quixote	키호테
ROM	ROM	롬
Rachel	레이철	레이첼
Radcliffe	래드클리프
Radel	라델
Rahman	라흐만
Raiders	레이더스
Rajasthan	라자스탄
Rajiv	라지브
Raleigh	롤리
Ralph	랄프	랠프
Ramadi	라마디
Ramallah	라말라
Ramanujan	라마누잔
Rambo	람보
Rambus	램버스
Ramirez	라미레즈
Ramon	라몬
Ramos	라모스
Ramses	람세스
Ramsey	램지
Randall	랜달	랜덜
Randolph	랜돌프
Randy	랜디
Ranieri	라니에리
Rao	라오
Rapunzel	라푼젤
Rashad	라샤드
Rashid	라시드
Rasmussen	라스무센
Raspberry	라즈베리
Ratan	라탄
Ratatouille	라따뚜이
Raul	라울
Raven	레이븐
Rawalpindi	라왈핀디
Raymond	레이먼드	레이몬드
Reagan	레이건
Rebecca	레베카
Rebekah	리브가
Red Cross	적십자
Red Hat	레드햇	빨간 모자
Red Sea	홍해
Red Sox	레드삭스
Redford	레드포드
Redmond	레드먼드	레드몬드
Reds	레즈
Redwood	레드우드
Reebok	리복
Reeves	리브스
Regan	리건
Regent	리젠트
Regina	레지나
Reigncom	레인콤
Reina	레이나
Rem	렘
Rembrandt	렘브란트
Remington	레밍턴
Remy	레미
Renault	르노
Renault Samsung	르노 삼성
Reno	리노
Renoir	르누아르	르느와르
Reston	레스턴
Reuters	로이터
Revel	르벨
Rex	렉스
Reyes	레예스
Reykjavik	레이캬비크
Reynolds	레이놀즈
Reza	레자
Rhine	라인강
Rhode Island	로드 아일랜드
Rhodes	로도스
Ricardo	리카도	리카르도
Richard	리차드	리챠드	리처드	리쳐드	리하르트
Richards	리차즈	리처즈
Richardson	리차드슨	리처드슨
Richmond	리치먼드	리치몬드
Ricky	리키
Ridley	리들리
Rihanna	리한나
Riley	라일리
Rio	리오	리우
Rio de Janeiro	리우데자네이루
Ripley	리플리
Rita	리타
Ritz	리츠
Rivera	리베라
Rivet	리벳
Riviera	리비에라
Riyadh	리야드
Roald	로알드
Robben	로벤
Robert	로버트	로베르
Roberta	로버타	로베르타
Roberto	로베르토
Roberts	로버츠
Robertson	로버슨	로버트슨
Robin	로빈
Robins	로빈스
Robinson	로빈슨
RoboCop	로보캅
Rocco	로코
Roche	로슈	로체
Rochester	로체스터
Rockefeller	록펠러
Rockefeller Center	록펠러 센터
Rockies	로키스
Rockwell	로크웰	록웰
Rocky Mountains	로키 산맥
Roddick	로딕
Rodeo	로데오
Rodin	로댕
Rodman	로드먼
Rodrigo	로드리고
Rodriguez	로드리게스	로드리게즈
Rogers	로저스
Roland	로랜드	롤랜드
Rolex	롤렉스
Rollins	롤린스
Rolls Royce	롤스로이스
Roman	로마	로만
Romania	루마니아
Romano	로마노
Romanov	로마노프
Rome	로마
Romeo	로미오
Romer	로머
Romero	로메로
Romney	롬니
Romulus	로물루스
Ronald	로날드	로널드
Ronaldinho	호나우지뉴
Ronaldo	호나우두	호날두
Ronan	로난
Ronnie	로니
Ronson	론슨
Rookie	루키
Rooney	루니
Roosevelt	루스벨트	루즈벨트
Roppongi	롯폰기
Rosa	로사	로자
Rosalie	로잘리
Rosalind	로살린드	로잘린드
Rosemary	로즈마리	로즈메리
Rosen	로젠
Rosenberg	로젠버그
Rosenthal	로젠탈
Rosetta Stone	로제타석
Rosie	로지
Rossi	로시
Rosslyn	로슬린
Roswell	로스웰
Rothschild	로스차일드
Rotterdam	로테르담
Rottweiler	로트와일러
Rouge	루주
Rousseau	루소
Routing	라우팅
Rover	로버
Rovers	로버스
Rowan	로완
Roy	로이
Royce	로이스
Ruben	루벤
Rubens	루벤스
Rubin	루빈
Rubio	루비오
Ruby	루비
Rucker	러커
Rudd	러드
Rudolf	루돌프
Rudy	루디
Rufus	루퍼스
Rumsfeld	럼스펠드	럼즈펠드
Rupert	루퍼트
Ruskin	러스킨
Russell	러셀
Russia	러시아
Ruth	루스
Rwanda	르완다
Ryan	라이언
S1	에스원
SBS
SDI
SDS
SK Telecom	SK 텔레콤	SKT
SM	SM	에스엠
Saakashvili	사카쉬빌리
Sabah	사바
Sable	세이블
Sabrina	사브리나
Sacramento	새크라멘토
Sadat	사다트
Saddam	사담
Saddam Hussein	사담 후세인
Sadr	사드르
Saehan	새한
Saemangeum	새만금
Sagan	세이건
Saha	사하
Sahara	사하라
Saigon	사이공
Sailor	세일러
Saipan	사이판
Saitama	사이타마
Saito	사이토
Sakai	사카이
Sakamoto	사카모토
Sakhalin	사할린
Saladin	살라딘
Salam	살람
Salamanca	살라망카
Saleh	살레
Salem	살렘	세일럼
Salinas	살리나스
Salinger	샐린저
Salisbury	솔즈베리
Sally	샐리	셀리	쌜리
Salomon	살로몬
Salt Lake	솔트 레이크
Salt Lake City	솔트 레이크 시티
Salvador	살바도르
Salvatore	살바토레
Salzburg	잘츠부르크
Samaria	사마리아
Samcheok	삼척
Samir	사미르
Sammy	새미
Sampras	샘프라스
Sampson	샘슨
Samson	삼손
Samsung	삼성
Samsung Card	삼성 카드
Samsung Electro-Mechanics	삼성 전기
Samsung Electronics	삼성 전자
Samsung Mall	삼성 몰
Samsung Securities	삼성 증권
Samuel	사무엘	사뮤엘	새뮤얼
Samyang	삼양
Samyoung	삼영
San	샌
San Antonio	샌 안토니오
San Diego	샌 디에고	샌 디에이고
San Francisco	샌 프란시스코
San Jose	산 호세
San Marino	산 마리노
Sanchez	산체스
Sandberg	샌드버그	샌버그
Sandel	샌델
Sander	샌더
Sanders	샌더스
Sanderson	샌더슨
Sandia	산디아
Sandinista	산디니스타
Sandler	샌들러
Sandra	산드라	샌드라
Sandro	산드로
Sandy	샌디
Sanford	샌포드
Sangam	상암
Sanrio	산리오
Santa	산타
Santa Claus	산타	산타 클로스
Santa Fe	산타페
Santa Maria	산타 마리아
Santa Monica	삳타 모니카	샌타 모니카
Santander	산탄데르
Santiago	산티아고
Santorini	산토리니
Santos	산토스
Sanyo	산요
Sao Paulo	상파울루
Sapporo	삿포로
Sarah	새라	세라
Sarajevo	사라예보
Sarandon	서랜든
Sardinia	사르디니아
Sarkozy	사르코지
Sartre	사르트르
Sasaki	사사키
Sasha	사샤
Sato	사토
Satoshi	사토시
Saturn	새턴	토성
Saud	사우드
Saudi Arabia	사우디	사우디아라비아
Saul	사울
Saunders	선더스	손더스
Saussure	소쉬르
Savoy	사보이
Sawyer	소여
Saxon	색슨
Saxony	작센
Scalia	스칼리아
Scandinavia	스칸디나비아
Scarlet	스칼렛
Schema	스키마
Schiffer	쉬퍼
Schindler	쉰들러
Schmidt	슈미트
Schneider	슈나이더
Schoenberg	쇤베르크
Scholes	스콜스
Schroeder	슈뢰더
Schubert	슈베르트
Schulz	슐츠
Schumacher	슈마허
Schumann	슈만
Schuster	슈스터
Schwartz	슈와르츠	슈워츠
Schwarzenegger	슈왈제네거	슈워제네거
Scolari	스콜라리
Scorsese	스콜세지
Scott	스캇	스코트	스콧
Scottish	스코틀랜드	스코티쉬	스코티시
Scotty	스코티
Scranton	스크랜턴
Scripps	스크립스
Scrooge	스크루지
Scud	스커드
Scully	스컬리
Sears	시어스	시어즈
Seattle	시애틀
Sebastian	세바스찬	세바스챤	세바스티안	세바스티앙
Security Council	안보리	안전 보장 이사회
Sega	세가
Seho	세호
Sehwa	세화
Seibu	세이부
Seiko	세이코
Seine	세느	세느강	센강
Sejin	세진
Sejo	세조
Sejong	세종
Selby	셀비
Selena	셀레나
Seligman	셀리그먼
Sendai	센다이
Senegal	세네갈
Senkaku	센카쿠
Sentosa Island	센토사 섬
Seocho	서초
Seodaemun	서대문
Seokguram	석굴암
Seomjin River	섬진강
Seondeok	선덕
Seongnam	성남
Seosan	서산
Seoul	서울
Seoul Bank	서울 은행
Seoul Forest	서울숲
Seoul Land	서울 랜드
Seoul National University	SNU	서울 대학교	서울대
Seoul Plaza	서울 광장
Seoul Station	서울역
Sera	세라
Serbia	세르비아
Serena	세레나
Serengeti	세렝게티
Sergio	세르지오	세르히오
Serie	세리
Seville	세빌
Seychelles	세이셸
Seymour	시모어
Shakespeare	셰익스피어
Shakira	샤키라
Shale	셰일
Shalit	샬리트
Shalom	샬롬
Shana	샤나
Shandong	산동	산둥
Shane	셰인	쉐인
Shanghai	상하이	상해	샹하이
Shannon	샤논	섀넌
Shaolin	소림
Shapiro	샤피로
Shaquille	샤킬
Sharaf	샤라프
Sharapova	샤라포바
Sharif	샤리프
Sharma	샤르마
Sharon	샤론
Shaukat	샤우카트
Shay	셰이
Sheffield	셰필드
Sheila	쉴라
Shelby	셸비	쉘비
Sheldon	쉘든
Shelly	셸리	쉘리
Shelton	쉘턴	쉘튼
Shenzhen	심천
Shenzhou	선저우
Sherbet	샤베트	셔벗
Sherlock	셜록
Sherman	셔먼
Sherpa	셰르파
Sherry	셰리	쉐리
Sherwood	셔우드
Shetland	셰틀랜드
Shibuya	시부야
Shields	쉴즈	실즈
Shigeo	시게오
Shigeru	시게루
Shikoku	시코쿠
Shilla	신라
Shilla Hotel	신라 호텔
Shiloh	샤일로
Shimada	시마다
Shinhan	신한
Shinhan Bank	신한 은행
Shinjuku	신주쿠
Shinkansen	신칸센
Shintaro	신타로
Shinyoung	신영
Shirley	셜리
Shoichi	쇼이치
Shoji	쇼지
Shrek	슈렉
Shriver	슈라이버
Shwe	슈웨
Siam	시암
Siberia	시베리아
Siberian	시베리아	시베리안
Sichuan	쓰촨
Sicily	시실리	시칠리아
Siddhartha	싯다르타
Siegel	시겔
Siemens	지멘스
Sienna	시에나
Sierra	시에라
Sierra Leone	시에라리온
Sigmund	지그문트
Sikorsky	시코르스키
Silicon Valley	실리콘밸리
Silva	실바
Silverman	실버맨
Silvio	실비오
Simba	심바
Simmons	시몬스
Simon	사이먼	사이몬	시몬
Simpson	심슨	심프슨
Sinai	시나이
Sinatra	시나트라
Sinclair	싱클레어
Singapore	싱가포르	싱가폴
Singh	싱
Sinpo	신포
Sinuiju	신의주
Sistani	시스타니
Sistar	시스타
Sistine	시스티나
Skull	두개골	스컬	해골
Skype	스카이프
Sloan	슬로언	슬론
Sloane	슬론
Slobodan	슬로보단
Slovakia	슬로바키아
Smiley	스마일리
Smithsonian	스미소니언	스미스소니언
Smurf	스머프
Snider	스나이더
Snow White	백설
Sochi	소치
Socialist Party	사회당
Societe	소시에테
Socrates	소크라테스
Sodom	소돔
Sogang	서강
Sokcho	속초
Solana	솔라나
Solaris	솔라리스
Solenoid	솔레노이드
Solomon	솔로몬
Soltani	솔타니
Somalia	소말리아
Somerset	서머셋
Sondheim	손드하임
Songhua	송화	쑹화
Songpa	송파
Songwon	송원
Sonia	소니아
Sonic	소닉
Sonoma	소노마
Sony	소니
Sonya	소냐
Soongsil University	숭실대
Sophia	소피아
Sophie	소피
Sophocles	소포클레스
Soriano	소리아노
Soribada	소리바다
Soros	소로스
Soto	소토
Sotomayor	소토마요르
South Africa	남 아프리카	남 아프리카 공화국	남아공
South America	남 아메리카	남미	중남미
South Asia	남아시아
South Carolina	사우스캐롤라이나
South Korea	남조선	남한	대한 민국	한	한국
South Pacific	남 태평양
South Sudan	남 수단
South Vietnam	남 베트남
Southampton	사우샘프턴
Southeast Asia	동남 아시아	동남아
Southwest Asia	서남 아시아
Soviet	소련	소비에트
Soviet Union	USSR	러시아	소련	소비에트	소비에트 연방
Soweto	소웨토
Spacey	스페이시
Spain	스패니쉬	스패니시	스페인	스페인어	에스파냐
Sparks	스팍스
Sparta	스파르타
Spartacus	스파르타쿠스
Specter	스펙터
Spence	스펜스
Spiderman	스파이더맨
Spiegel	슈피겔	스피겔
Spielberg	스필버그
Spinoza	스피노자
Spitzer	스피처
Springfield	스프링필드
Sputnik	스푸트니크
Sri Lanka	스리랑카
Ssangyong	쌍용
Stacy	스테이시
Stalin	스탈린
Stalingrad	스탈린그라드
Stallone	스탤론
Stamford	스탬퍼드
Stan	스탠
Stanford	스탠퍼드	스탠포드
Stanley	스탠리
Stanton	스탠튼
Stapler	스테이플러	호치키스
Stapleton	스테이플턴
Star Trek	스타 트렉
Star Wars	스타 워즈
State Department	국무부
Steelers	스틸러스
Steen	스틴
Stefan	스테판
Stefano	스테파노
Steinbeck	스타인벡
Steinberg	스타인버그
Steinbrenner	스타인브레너
Stephanie	스테파니
Stephen	스티븐
Sterling	스털링
Steve	스티브
Stevie	스티비
Steward	스튜어드
Stewart	스튜어트	스튜워트
Stiglitz	스티글리츠
Stinger	스팅어
Stockholm	스톡홀름
Stonehenge	스톤헨지
Stony	스토니
Stradivari	스트라디바리
Strasbourg	스트라스부르
Stratford	스트랫포드
Strauss	슈트라우스	스트라우스
Stravinsky	스트라빈스키
Strel	스트렐
Stringer	스트링거
Strobe	스트로브
Stuttgart	슈투트가르트
Styx	스틱스
Suez	수에즈
Suharto	수하르토
Sulawesi	술라웨시섬
Sullivan	설리반	설리번
Sully	설리
Sumatra	수마트라
Sumatra Island	수마트라섬
Sumer	수메르
Sumitomo	스미토모
Sun Microsystems	선 마이크로시스템스	선 마이크로시스템즈	썬 마이크로시스템스	썬 마이크로시스템즈
Sun Yang	쑨양
Suncheon	순천
Sundance	선댄스
Sunderland	선더랜드	선덜랜드
Sung Yuri	성유리
Sungjin	성진
Sungkyunkwan	성균관
Sungnyemun	숭례문
Suntory	산토리
Super Junior	슈쥬	슈퍼주니어
Superman	수퍼맨	슈퍼맨
Supreme Court	대법원	법원
Surfboard	서프보드
Susan	수잔	수전
Susanna	수잔나
Suseo	수서
Sussex	서섹스
Sutherland	서덜랜드
Sutton	서튼
Suwon	수원
Suzhou	쑤저우
Suzuki	스즈키
Sven	스벤
Svetlana	스베틀라나
Swahili	스와힐리어
Swami	스와미
Swansea	스완지
Swanson	스완슨
Swatch	스와치
Sweden	스웨덴
Swedish	스웨덴
Sweeney	스위니
Swenson	스웬슨
Swinton	스윈튼
Swiss	스위스
Switzerland	스위스
Sydney	시드니
Sylvester	실베스타	실베스터
Sylvia	실비아
Syngman Rhee	이승만
Syracuse	시러큐스
Syria	시리아
TFT LCD
THAAD	사드
TV	TV	테레비	텔레비전	텔레비젼	티브이	티비
TVXQ	동방신기
Tabasco	타바스코
Tacloban	타클로반
Tadic	타디치
Taean	태안
Taejo	태조
Taejong	태종
Taesan	태산
Taesung	태성
Taewon	태원
Taft	태프트
Tahir	타히르
Tahiti	타히티
Tahoe	타호
Tahrir	타흐리르
Taipei	타이베이	타이페이
Taiwan	대만	타이완
Taizhou	타이저우
Taj Mahal	타지마할
Tajikistan	타지키스탄
Taka	타카
Takashi	다카시	타카시
Takeda	다케다
Takeo	다케오
Takeshi	타케시
Takeshita	다케시타
Talabani	탈라바니
Tales Weaver	테일즈 위버
Taliban	탈레반
Talmud	탈무드
Tamarind	타마린드
Tamil	타밀	타밀족
Tammy	태미
Tampa	탬파
Tamura	타무라
Tanabe	다나베
Tanaka	다나카	타나카
Tangier	탕헤르
Tangjeong	탕정
Tanner	태너
Tanya	타냐
Tanzania	탄자니아
Taormina	타오르미나
Tara	타라
Taran	타란
Tarantino	타란티노
Tariq	타리크
Taro	다로	타로
Tartar	타르타르
Tarzan	타잔
Tashkent	타슈켄트
Tasmania	태즈메이니아
Tata	타타
Tate	테이트
Tatiana	타티아나
Tatum	테이텀
Taurus	토러스
Tbilisi	트빌리시
Tchaikovsky	차이코프스키	차이콥스키
Technica	테크니카
Ted	테드
Teddy	곰 인형	테디
Teheran	테헤란
Tel Aviv	텔 아비브
Telefonica	텔레포니카
Telson	텔슨
Telson Electronics	텔슨 전자
Tempelhof	템펠호프
Templeton	템플턴
Tempura	덴뿌라	뎀뿌라
Tenet	테닛
Tennessee	테네시
Tennyson	테니슨
Teresa	테레사
Terminator	터미네이터
Terrence	테렌스
Terry	테리
Tesla	테슬라
Texas	텍사스
Thailand	태국
Thaksin	탁신
Thales	탈레스
Thames	테임즈	템스	템즈
Theo	테오
Theodore	시어도어	테오도어
Theseus	테세우스
Thierry	티에리
Thomas	토마스	토머스
Thompson	톰슨
Thor	토르
Thornton	손튼
Three Musketeers	삼총사
Thrunet	두루넷
Thursday	목	목요일
TiVo	티보
Tia	티아
Tiana	티아나
Tiananmen	천안문	톈안먼
Tianjin	천진	톈진
Tibet	티베트	티벳
Tiffany	티파니	티퍼니
Tiger Woods	타이거 우즈
Tigris	티그리스
Tijuana	티후아나
Tilda	틸다
Tillman	틸먼
Tilon	틸론
Times Square	타임 스퀘어	타임스 스퀘어	타임즈 스퀘어
Timmons	티몬스
Timmy	티미
Timor	티모르
Timothy	티모시
Timur	티무르
Tina	티나
Tinkerbell	팅커벨
Titan	타이탄
Titanic	타이타닉
Tito	티토
Tivoli	티볼리
Tmax	티맥스
Tobago	토바고
Tobias	토비아스
Tobin	토빈
Toby	토비
Tocqueville	토크빌
Toegye	퇴계
Toffler	토플러
Togo	토고
Tokugawa	도쿠가와
Tokuyama	도쿠야마
Tokyo	도쿄	동경	토쿄
Toledo	톨레도
Tolkien	톨킨
Tolstoy	톨스토이
Tom	탐	톰
Tom Cruise	탐 크루즈	톰 크루즈
Tom Yam Kung	똠냥꿍
Tom Yum Goong	똠냥꿍
Tom Yum Kung	똠냥꿍
Tomita	토미타
Tomkins	톰킨스
Tommy	토미
Toms	톰스
Tonga	통가
Tongyeong	통영
Tony	토니
Tony Award	토니 상
Toolbar	툴바
Toon	툰
Toronto	토론토
Torre	토레
Torres	토레스
Tortilla	또르띠야	토르티야
Toshiba	도시바
Toto	토토
Totoro	토토로
Tottenham	토트넘
Totti	토티
Tottori	돗토리
Toulouse	툴루즈
Townsend	타운센드
Toyota	도요타	토요타
Toyotomi	도요토미
Tracy	트레이시
Travis	트라비스	트래비스	트레비스
Travolta	트라볼타
Trent	트렌트
Trenton	트렌턴
Trevi	트레비
Trezeguet	트레제게
Tribune	트리뷴
Trinidad	트리니다드
Trinity	트리니티
Tripoli	트리폴리
Trisha	트리샤
Tristan	트리스탄
Tristar	트라이스타
Trotsky	트로츠키
Troy	트로이
Trudy	트루디
Truman	트루먼
Trump	트럼프
Ttukseom	뚝섬
Tucci	투치
Tucker	터커
Tudor	튜더
Tuesday	화	화요일
Tuner	튜너
Tunguska	퉁구스카
Tunis	튀니스
Tunisia	튀니지
Tupac	투팍
Turandot	투란도트
Turing	튜링
Turkish	터어키	터키
Turkmenistan	투르크메니스탄
Turner	터너
Turpin	터핀
Tuscany	투스카니
Tutankhamun	투탕카멘
Tutsi	투치족
Tutu	투투
Tuvalu	투발루
Twain	트웨인
Tycoon	타이쿤
Tyler	타일러
Tyrone	타이론
Tyson	타이슨
UNESCO	유네스코
UNICEF	유니세프
UNIQLO	유니클로
USA	USA	미국	유에스에이
USA Today	USA Today	USA 투데이	유에스 투데이	유에스에이 투데이
Uber	우버
Udall	우달
Ueda	우에다
Uehara	우에하라
Ueno	우에노
Uganda	우간다
Uijeongbu	의정부
Ukraine	우크라이나
Uljin	울진
Ulleungdo	울릉도
Ulrich	울리히
Ulsan	울산
Ultima	울티마
Ulysses	율리시스
Uma	우마
Umar	우마르
Underwood	언더우드
Unicom	유니콤
Unilever	유니레버
Unisem	유니셈
United Kingdom	UK	영국
United Nations	UN	국제 연합	유엔
United States	미국	아메리카
Unitel	유니텔
Unix	유닉스
Upton	업톤
Ural	우랄
Uribe	우리베
Uruguay	우루과이
Urumqi	우루무치
Utah	유타
Uzbekistan	우즈베키스탄	우즈벡
VAN	VAN	반	밴
VANK	반크
Vader	베이더
Valdes	발데스
Valencia	발렌시아
Valentin	발렌틴
Valentine	발렌타인	밸런타인
Valentino	발렌티노
Valerie	발레리
Valparaiso	발파라이소
Van Gogh	고흐	반 고흐
Vance	밴스
Vancouver	밴쿠버	벤쿠버
Vanessa	바네사
Vanuatu	바누아투
Varanasi	바라나시
Vargas	바르가스
Vatican	바티칸
Vegas	베가스
Velazquez	벨라스케스	벨라스케즈
Venetian	베네치아
Venezuela	베네수엘라
Venice	베네치아	베니스
Venter	벤터
Venus	금성	비너스
Vera	베라
Vermeer	베르메르
Vermont	버몬트
Vermouth	베르무트
Vernon	버논
Veron	베론
Versace	베르사체
Versailles	베르사유	베르사이유
Vicky	비키
Victor	빅터	빅토르
Victoria	빅토리아
Vieira	비에이라
Vienna	비엔나
Viet Cong	베트콩
Vietnam	베트남	월남
Vietnamese	베트남	월남
Viking	바이킹
Vince	빈스
Vincent	빈센트
Vinci	빈치
Virginia	버지니아
Visa	VISA	비자
Visa Card	비자카드
Vishnu	비슈누
Vivaldi	비발디
Vivian	비비안
Vlad	블라드
Vladimir	블라디미르
Vladivostok	블라디보스토크	블라디보스톡
Vodafone	보다폰
Vogue	보그
Voldemort	볼드모트
Volga	볼가
Volgograd	볼고그라드
Volkswagen	폭스바겐
Voltaire	볼테르
Volvo	볼보
Vronsky	브론스키
Wade	웨이드
Wagner	바그너	와그너
Waikiki	와이키키
Wakefield	웨이크필드
Walcott	월콧
Walden	월든
Waldheim	발트하임
Waldo	왈도
Wales	웨일스	웨일즈
Walesa	바웬사
Walid	왈리드
Walker	워커
Wall Street	월 가	월 스트리트	월 스트릿
Wallace	월래스	월러스	월레스	월리스
Wally	월리
Walsh	월쉬	월시
Walt	월트
Walt Disney	월트 디즈니
Walter	발터	월터
Walters	월터스
Walton	월튼
Wanderers	원더러스
Wando	완도
Wangsimni	왕십리
Warez	와레즈
Warhol	워홀
Warner	워너
Warnock	워녹
Warp	워프
Warren	워런	워렌
Warsaw	바르샤바
Warwick	워릭	워윅
Waseda	와세다
Washington	워싱턴	워싱톤
Washington Post	워싱턴 포스트
Watanabe	와타나베
Waterloo	워털루
Watkins	왓킨스
Watson	와트슨	왓슨
Watts	와츠	왓츠
Waxman	왁스먼
Wayne	웨인
Waziristan	와지리스탄
Weasley	위즐리
Weaver	위버
Weber	베버	웨버
Webster	웹스터
Webzen	웹젠
Wednesday	수	수요일
Wegener	베게너
Weibo	웨이보
Weihai	웨이하이
Weimar	바이마르
Weinberg	와인버그
Weiner	와이너
Weinstein	와인스타인
Weir	위어
Weiss	와이스
Welch	웰치
Weldon	웰든
Weller	웰러
Wells	웰스	웰즈
Welsh	웰쉬	웰시
Wembley	웸블리
Wen Jiabao	원자바오
Wendy	웬디
Wenger	벵거
Wenzhou	원저우
Werner	베르너
Werther	베르테르
Wes	웨스
Wesley	웨슬리
West Africa	서 아프리카
West Berlin	서 베를린
West End	웨스트엔드
West Germany	서독
West Point	웨스트포인트
West Virginia	웨스트버지니아
Western Asia	서 아시아
Western Europe	서 유럽
Westin	웨스틴
Westminster	웨스트민스터
Westwood	웨스트우드
Weymouth	웨이머스
Wharton	와튼
Wheatley	휘틀리
Wheeler	윌러	휠러
Whistler	휘슬러
Whitaker	휘태커
White House	백악관	화이트 하우스
Whitehead	화이트헤드
Whitman	위트먼	휘트먼
Whitmore	휘트모어
Whitney	휘트니
Whois	후이즈
Wiesbaden	비스바덴
Wight	와이트
Wikileaks	위키리크스
Wikipedia	위키피디아
Wilbur	윌버
Wilcox	윌콕스
Wilford	윌포드
Wilfred	윌프레드
Wilhelm	빌헬름
Wilkins	윌킨스
Wilkinson	윌킨슨
Willard	윌라드
William	윌리암	윌리엄
Williams	윌리암스	윌리암즈	윌리엄스	윌리엄즈
Williamsburg	윌리엄스버그
Williamson	윌리암슨	윌리엄슨
Willie	윌리
Willis	윌리스
Wilmington	윌밍턴
Wilshire	윌셔
Wilson	윌슨
Wiltshire	윌트셔
Wimax	와이맥스
Wimbledon	윔블던
Winchester	윈체스터
Windsor	윈저
Winfrey	윈프리
Winkle	윙클
Winkler	윙클러
Winnipeg	위니펙
Winona	위노나
Winslet	윈슬렛
Winston	윈스턴
Winstone	윈스톤
Winters	겨울	윈터스	윈터즈
Wisconsin	위스콘신
Witherspoon	위더스푼
Wittgenstein	비트겐슈타인
Wok	웍
Wolfgang	볼프강
Wolfowitz	울포위츠	월포위츠
Wonder Girls	원더걸스
Wonderland	원더랜드
Wong	웡
Wonjin	원진
Woodrow	우드로우
Woodstock	우드스톡
Woodward	우드워드
Woody	우디
Woongjin	웅진
Woongjin Coway	웅진코웨이
Wooyoung	우영
Worcester	우스터
Worcestershire	우스터셔
Wordsworth	워즈워스
World Bank	세계 은행
World Cup	월드컵
World Trade Organization	WTO	세계 무역 기구
World War	대전	세계 대전
Wowbook	와우북
Wozniak	워즈니악
Wroclaw	브로츠와프
Wyatt	와이어트
Wyoming	와이오밍
Wyverns	와이번스
X-Note	엑스노트
Xerox	제록스
Xi Jinping	시진핑
Xiao	샤오
Xilinx	자일링스
Yahoo	야후
Yahweh	야훼
Yale	예일
Yale University	예일 대학교	예일대
Yalu River	압록강
Yamada	야마다
Yamaguchi	야마구치
Yamaha	야마하
Yamamoto	야마모토
Yamanaka	야마나카
Yamanote	야마노테
Yamashita	야마시타
Yamato	야마토
Yamazaki	야마자키
Yanagi	야나기
Yanbian	옌볜
Yangon	양곤
Yangpyeong	양평
Yangtze	양쯔강
Yangzhou	양저우
Yankees	양키스	양키즈
Yantai	옌타이
Yao Ming	야오밍
Yasin	야신
Yasser	야세르
Yasuhiro	야스히로
Yasuhisa	야스히사
Yasukuni	야스쿠니
Yasuo	야스오
Yeats	예이츠
Yedang	예당
Yellow River	황하
Yellow Sea	황해
Yellowstone	옐로스톤
Yeltsin	옐친
Yemen	예멘
Yen	엔	옌
Yeoju	여주
Yeoncheon	연천
Yeongam	영암
Yeongdong	영동
Yeongwol	영월
Yeonpyeong	연평
Yeonpyeong Island	연평도
Yeonwoo	연우
Yeouido	여의도
Yoda	요다
Yoko	요코
Yokohama	요코하마
Yokosuka	요코스카
Yomiuri	요미우리
Yongbyon	영변
Yongin	용인
Yongsan	용산
Yonsei University	연대	연세대	연세대학교
Yoon	윤
York	요크
Yorkshire	요크셔
Yoruba	요루바
Yosemite	요세미티
Yoshida	요시다
Yoshiko	요시코
Youngjin	영진
Youngwoo	영우
Yousef	유세프
Youtube	유튜브
Yucatan	유카탄
Yugoslavia	유고슬라비아
Yukari	유카리
Yukata	유카타
Yuki	유키
Yukiko	유키코
Yukio	유키오
Yuko	유코
Yukos	유코스
Yuma	유마
Yunju	윤주
Yunus	유누스
Yutaka	유타카
Zachary	재커리
Zagreb	자그레브
Zahir	자히르
Zaire	자이르
Zakaria	자카리아
Zambia	잠비아
Zapatero	사파테로
Zaragoza	사라고사
Zebra	제브라
Zelda	젤다
Zeller	젤러
Zellweger	젤위거
Zenith	제니스
Zeppelin	제플린
Zeus	제우스
Zhengzhou	정저우
Zhou	저우	주
Zhou Enlai	저우언라이
Zidane	지단
Zimbabwe	짐바브웨
Zimmer	짐머
Zimmerman	지머맨	짐머만	짐머맨
Zinedine	지네딘
Zion	시온
Zoroaster	조로아스터
Zucker	주커
Zuckerberg	저커버그	주커버그
Zurich	쮜리히	취리히
Zvonareva	즈보나레바
ambassador	대사	앰배서더
antibiotic	항생
apocalypse	묵시록
apple	사과	애플
backbone	기간	백본
capone	카포네
cigar	담배	시가	시거
curry	카레	커리
dragon	드래곤	용
duke	공작	듀크
eBay	eBay	이베이
earl	백작	얼
flea market	벼룩 시장	플리 마켓
full browsing	풀 브라우징
full house	풀 하우스
gay bar	게이바
green house	그린 하우스
high five	하이 파이브
human rights	인권
iced tea	아이스 티
lead free	무연
meteor shower	유성우
mini bar	미니 바
peninsula	반도
pepper	페퍼	후추
prince	군주	왕	왕자	프린스
princess	공주	프린세스
regular expression	정규식	정규표현식
runtime	런타임
shipbuilding	조선
sign language	수화
sneakers	스니커즈	운동화
stomach cancer	위암
sulfuric acid	황산
summer	써머	서머	여름	하계
the US	미	미국
turkey	칠면조	터어키	터키
vice president	부사장	부총장	부통령	부회장
vocal cord	성대
whaling	포경
white night	백야
winter	겨울	동계	윈터	추위
