중국	Trung Quốc	Trung hoa	Tàu khựa	Tàu
미국	Mỹ	Hoa Kỳ	United States
일본	Nhật Bản
스페인	Tây Ban Nha
인도	Ấn Độ
십월	Tháng Mười
베트남	Việt Nam
대한민국	Hàn Quốc	Đại Hàn Dân Quốc
하나님	Thiên Chúa	Chúa Trời	Đức Chúa Trời	Thượng Đế	Đức Chúa
유럽	Châu Âu
뉴욕	New York
호치민	Hồ Chí Minh
상하이	Thượng Hải
선전	Thâm Quyến
광저우	Quảng Châu
칠면조	Thổ Nhĩ Kỳ
대만	Đài Loan
호치민시티	Thành phố Hồ Chí Minh
네덜란드	Hà Lan
구월	Tháng Chín
스위스	Thụy Sĩ
태국	Thái Lan
4월	Tháng Tư
폴란드	Ba Lan
광동	Quảng Đông
스웨덴	Thụy Điển
베이징	Bắc Kinh
그리스 어	Hy Lạp
홍콩	Hồng Kông
칠월	Tháng Bảy
팔월	Tháng Tám
이집트	Ai Cập
웨스턴 유니언	Western Union
스페인	Tây Ban Nha
예수	Chúa Giêsu	Chúa Jêsus
6월	Tháng Sáu
포르투갈	Bồ Đào Nha
중동	Trung Đông
2월	Tháng Hai
뉴질랜드	New Zealand
북 아메리카	Bắc Mỹ
치앙 마이	Chiang Mai
샤오미 미	Xiaomi Mi
나트랑	Nha Trang
1월	Tháng Một
덴마크	Đan Mạch
에바 항공	EVA Air
코롱	Koh Rong
강소	Giang Tô
저장성	Chiết Giang
남동쪽	Đông Nam
아프리카	Châu Phi
하노이	Hà Nội
타이베이	Đài Bắc
로스 앤젤레스	Los Angeles
유대인	Do Thái
샌프란시스코	San Francisco
남아메리카	Nam Mỹ
동관	Đông Quan
금요일	Thứ Sáu
산동	Sơn Đông
남아프리카	Nam Phi
월요일	Thứ Hai
핀란드	Phần Lan
그리스도	Chúa Kitô
다낭	Đà Nẵng
노르웨이	Na Uy
소련	Liên Xô
로마 인	La Mã
5월	Tháng Năm
허베이	Hà Bắc
호이안	Hội An
칭다오	Thanh Đảo
3월	Tháng Ba
오르페크 대서양	Orphek Atlantik
알렉시스 텍사스	Alexis Texas
창저우	Thường Châu
런던	Luân Đôn
데카 듀라볼린	Deca Durabolin
포산	Phật Sơn
재팬 호퍼스	Japan Hoppers
라스베가스	Las Vegas
크리스마스	Giáng Sinh
항저우	Hàng Châu
일요일	Chủ Nhật
붕따우	Vũng Tàu
라즈베리 파이	Raspberry PI
천진	Thiên Tân
캐세이퍼시픽	Cathay Pacific
비 소스	Vô Tích
코스타리카	Costa Rica
메르세데스 벤츠	Mercedes Benz
리그	Liên Minh
아모이	Hạ Môn
유텔새트 핫	Eutelsat Hot
트러스트 월렛	Ví Trust	Trust Wallet
닝보	Ninh Ba
우한	Vũ Hán
뉴저지	New Jersey
피피	Phi Phi
안토니오 모나코	Antonio Monaco
콘티넨탈 오토모티브	Tô Châu
씨엠립	Xiêm Riệp	Siem Reap
흐무브 도	Hmoob Daw
푸꾸옥	Phú Quốc
대런 피트필드	Darren Pitfield
아세리스 법칙	Luật Aceris
난징	Nam Kinh
토요일	Thứ Bảy
북한	Triều Tiên	Bắc Hàn	Bắc Triều Tiên
샤오미 홍미	Xiaomi Redmi
앱 스토어	App Store
핫스팟 쉴드	Hotspot Shield
알카트라즈 크루즈	Alcatraz Cruises
1월	Tháng Giêng
사우디 아라비아	Ả Rập Saudi	Ả Rập Xê Út
지구	Trái Đất
5월	Tháng Năm
영국	Anh Quốc	Anh	nước Anh
동유럽	Đông Âu
호안끼엠	Hoàn Kiếm
존 디어	John Deere
볼데논 운데실레네이트	Boldenone Undecylenate
지중해	Địa Trung Hải
청두	Thành Đô
중화항공	China Airlines	hãng hàng không Trung Quốc
경영대학	Trường đại học Kinh Tế
샌디에고	San Diego
충칭	Trùng Khánh
스리랑카	Sri Lanka
화요일	Thứ Ba
석가	Thạch Gia
미주	Châu Mỹ
코파	COPPA
카오프라	Khao Phra
상페드로	Sao Pedro
라틴 아메리카	Mỹ Latinh
북서	Tây Bắc
보트 키	Boat Quay
목요일	Thứ Năm
알레타 오션	Aletta Đại dương
마리나 베이	Marina Bay
뉴 올리언스	New Orleans
수요일	Thứ Tư
하이 베이	High Bay
알카트라즈 섬	Alcatraz Island
탄빈	Tân Bình
온주	Ôn Châu
후난	Hồ Nam
하남	Hà Nam
십월	Tháng Mười
루앙프라방	Luang Prabang	Luổng Phạ Bang	Luông Pra Băng	Luông Pha Băng
랜드로버	Land Rover
도날드 트럼프	Donald Trump
클래시 로얄	Clash Royale
완차이	Quận Loan Tể	Wan Chai
해리 포터	Harry Potter
그래핀 테마	Graphene Theme
비엔안	Viên An
바이낸스 아카데미	Học viện Binance Academy	Học viện Binance
발렌타인 데이	Ngày Valentine
북유럽	Bắc Âu
응우옌 꾸인	Nguyễn Quỳnh
데이비드 워린	David Warin
크리스 아모라	Kris Amora
대한항공	Korean Air	Hãng hàng không Hàn Quốc
뉴 델리	Niu Đê-li	New Delhi
몽골리아	Mông Cổ
하롱	Hạ Long
서유럽	Tây Âu
돈 그램	Money Gram
쿠알라 룸푸르	Kuala Lumpur
프놈펜	Phnôm Pênh	Phnom Penh
부에노스 아이레스	Buenos Aires
바딘	Ba Đình
베이비 헤이즐	Bé Hazel	Baby Hazel
지난	Tế Nam
트렌볼론 아세테이트	Trenbolone Acetate
구월	Tháng chín
부활절	Lễ Phục Sinh
복음	Phúc Âm
북동	Đông Bắc
시안	Tây An
중서부	Trung Tây
말레이 사람	Người Mã Lai
클락 키	Bến Clarke	Clarke Quay
트렌볼론 에난테이트	Trenbolone Enanthate
쓰촨	Tứ Xuyên
남서	Tây Nam
정저우	Trịnh Châu
국가의 날	Ngày Quốc Khánh
차오훙	Cao Hùng
까우자이	Cầu Giấy
그리스도	Đấng Christ
우루과이 페소	Peso Uruguay
드 크리스티안	De Cristian
다이와 로이넷	Daiwa Roynet
복건	Phúc Kiến
장자	Trương Gia
몽콕	Vượng Giác	Mong Kok
애비 브룩스	Abbey Brooks
빈즈엉	Bình Dương
에바 디바인	Ava Devine
호주	Châu Úc
아부 다비	Abu Dhabi
달랏	Đà Lạt
워싱턴 DC	Washington DC
푸에르토 리코	Puerto Rico
판 티엣	Phan Thiết
고레티 호	Goretti Ho
빈탄	Bình Thạnh
에바 아담스	Ava Addams
푸동 신쿠	Phố Đông	Pudong Xinqu
난드롤론 데카노에이트	Nandrolone Decanoate
치아 라구나	Chia Laguna
샤오미 미지아	Xiaomi Mijia
꼬따오	Koh Tao
칠월	Tháng Bảy
사이공	Sài Gòn
데이비드 짐머만	David Zimmerman
앨리 헤이즈	Allie Haze
상파울루	Sao Paulo
호 타그바	Ho Taghva
구기자	Câu Kỷ Tử	Goji Berries
볼데논 키피오네이트	Boldenone Cypionate
노스 캐롤라이나	Bắc Carolina
법률 학교	Trường Luật
스위스	Thụy Sỹ
카오산 월드	Khaosan World
후베이	Hồ Bắc
여요	Dư Diêu
캔톤 페어	Canton Fair
로버트슨 키	Robertson Quay
컬럼비아	Columbia
후이저우	Huệ Châu
아사 아키라	Asa Akira
선전	Thẩm Quyến
토요일	Thứ Bảy
안후이	An Huy
덴마크	Đan Mạch
산호세	San Jose
브리티시 컬럼비아	British Columbia
구로사와 아이	Ai Kurosawa
줄리아 앤	Julia Ann
에바 안젤리나	Eva Angelina
빅뱅	Big Bang
왓 카오	Wat Khao
프라 밧	Phra Bat
메리 샤프	Mary Sharpe
치앙 라이	Chiang Rai
알리사 홀	Allyssa Hall
트엉 사	Trường Sa
금요일	Thứ Sáu
남하이	Nam Hải
파타야	Pattaya
카오산 도쿄	Khaosan Tokyo
하롱	Hạ Long
묵시	Khải Huyền
흐엉 센	Hương Sen
드 아드리안	De Adrian
티베트	Tây Tạng
산타아나	Santa Ana
랑하	Láng Hạ
네덜란드	Hà Lan
브리트니 스피어스	Britney Spears
바비 스타	Bobbi Starr
아이 유메미	Ai Yumemi
투안 차우	Tuấn Châu
트립 리	TRIP LEE
샌 안토니오	San Antonio
레인지로버	Range Rover
꽝남	Quảng Nam
나브크 베이	Nabq Bay
멕시코 시티	Thành phố Mexico
후아힌	Hua Hin
텔 아비브	Tel Aviv
산타 클로스	Santa Claus
사파	Sa Pa
에이미 리드	Amy Reid
앨리 조던	Allie Jordan
남부 트리우	Nam Triều
남룡	Nam Liong
코니카 미놀타	Konica Minolta
김호아	Kim Hoa
닌빈	Ninh Bình
마이클 잭슨	Michael Jackson
팔월	Tháng Tám
시지 공위안	ShiJi GongYuan
레알 마드리드	Real Madrid
추수감사절	Lễ Tạ Ơn
룽양로	Longyang Rd
아미아 모레티	Amia Moretti
알라나 레이	Alanah Rae
비엔동	Viễn Đông
탄 호아이	Thanh Hoài
화롄시	Hualien City
한나 몬타나	Hannah Montana
하이퐁	Hải Phòng
웨이팡	Duy Phường
크리스토프 마르츠	Christophe Martz
공립 연구소	Viện nghiên cứu Công Lập
신약성경	Kinh thánh Tân Ước
탄빈	Thanh Bình
나이아가라 폭포	Thác Niagara
프란체스카 르	Francesca Le
엘살바도르	El Salvador
빌 게이츠	Bill Gates
공산당	Đảng Cộng Sản
타오위안	Đào Viên
공립학교	Trường Công Lập
중산	Trung Sơn
케이티 페리	Katy Perry
카메론 캐나다	Cameron Canada
레이디 가가	Lady Gaga
제시카 방콕	Jessica Bangkok
월트 디즈니	Walt Disney
폴 루터란	Paul Lutheran
무옹 탄	Mường Thanh
에즈 렌다	Ez Renda
체이스 윌리엄스	Chase Williams
찰리 체이스	Charley Chase
북아일랜드	Bắc Ireland
방비엥	Vang Vieng
서아프리카	Tây Phi
세인트 피터스 버그	Thành phố Thánh Phêrô	Sankt-Petersburg
노보텔 다낭	Novotel Đà Nẵng
미우미우	Miu Miu
IH 브리즈번	IH Brisbane
데일 카네기	Dale Carnegie
케이프 타운	Cape Town
바이짜이	Bãi Cháy
애니 크루즈	Annie Cruz
냥쉐	Nyaung Shwe
제임스 본드	James Bond
포트 워스	Fort Worth
두이 탄	Duy Tân
애스턴 마틴	Aston Martin
마틴 루터	Martin Luther
조니 씬	Johnny Sins
David Unthank	David Unthank
사라센 베이	Vịnh Saracen
아랍에미리트	các Tiểu vương quốc Ả Rập Thống Nhất	United Arab
샤리프 라로슈	Sharif LaRoche
스쿠비 두	Scooby Doo
산타 마리아	Santa Maria
오렌지 카운티	Quận Cam
퐁냐	Phong Nha
오차드 로드	Orchard Road
마일리 사이러스	Miley Cyrus
커민	Cumin
버락 오바마	Barack Obama
에이미 브룩	Amy Brooke
일본어학교	Trường Tiếng Nhật
천칭	Thiên Bình
비틀즈	The Beatles
상파울루	São Paulo
스티브 잡스	Steve Jobs
산후안	San Juan
코란타	Ko Lanta
조지 워싱턴	George Washington
프랑코 콩고	Franco Congo
데본 리	Devon Lee
다니 다니엘스	Dani Daniels
안 호아	An Hòa
카티아 노빌리	Kathia Nobili
저스틴 비버	Justin Bieber
홍 치앙	Hong Chiang
우크라이나	Ukraina
징크스 미로	Jynx Maze
기독교	Cơ Đốc Giáo
오스틴 ISD	Austin ISD
에이든 아스펜	Aiden Aspen
카톨릭 교회	Đạo Công Giáo
인민당	Đảng Nhân Dân
탄 쑤언	Thanh Xuân
산마르코	San Marco
롱강 지구	Long Cương
마카오	Ma Cao
빈 투언	Bình Thuận
비벌리 힐스	Beverly Hills
안젤리나 졸리	Angelina Jolie
동다	Đống Đa
다롄	Đại Liên
산타 크루즈	Santa Cruz
푸미	Phú Mỹ
푸하이	Phú Hải
뉴잉글랜드	New England
레 탄	Lê Thanh
인도네시아 아일랜드	Indonesia Ireland
독일 셰퍼드	German Shepherd
이스트 미들랜즈	East Midlands
비시 자이시	Bish Jaishi
알버트 아인슈타인	Albert Einstein
쩐푸	Trần Phú
솔트레이크	Salt Lake
푸누안	Phú Nhuận
로스 아르볼레스	Los Arboles
롱아일랜드	Long Island
허페이	Hợp Phì
하워드 존슨	Howard Johnson
오드리 비토니	Audrey Bitoni
알렉시스 폭스	Alexis Fawx
아드리아나 니콜	Adrianna Nicole
아비가일 존슨	Abigaile Johnson
아벨라 앤더슨	Abella Anderson
윌리엄 커틀리	William Kirtley
월스트리트	Phố Wall
꽝닌성	Tỉnh Quảng Ninh
쩐 훙	Trần Hùng
탄 투이	Thanh Thủy
셀레나 고메즈	Selena Gomez
산타페	Santa Fe
뮤드퍼드 키	Mudeford Quay
버마	Miến Điện
리장	Lệ Giang
엘패소	El Paso
가톨릭	Công Giáo
앤 해서웨이	Anne Hathaway
비엔티안	Viêng Chăn
목요일	Thứ Năm
팜스프링스	Suối Palm
로리 소드	Lori Soard
란타섬	Koh Lanta
하포드 카운티	Harford County
한스 코트케	Hans Kottke
조지타운	George Town
FC 바르셀로나	FC Barcelona
앨리 제임스	Allie James
산타 바바라	Santa Barbara
쁘띠 베인	Petit Bain
링꽝	Linh Quang
캔자스시	Kansas City
캐그니 린	Kagney Linn
엠마 팀	Emma Tim
창 사바이	Chang Sabai
아드리아나 루나	Adrianna Luna
구정	Tết Nguyên Đán
티옹 바루	Tiong Bahru
꾸옥 안	Quốc Anh
풍황	Phụng Hoàng
나스리	Nasri
루 루	Lu Lu
리틀 인디아	Little India
켄달 제너	Kendall Jenner
제이든 제임스	Jayden James
호 트램	Hồ Tràm
그란 카나리아	Gran Canaria
포트 로더데일	Fort Lauderdale
엘룬다 베이	Elounda Bay
케이프 베르딘	Cape Verdean
알 자지라	Al Jazeera
호주 바레인	Úc Bahrain
신장	Tân Cương
속산	Sok San
시온	Si Ôn
상 라파엘	Sao Rafael
산타클라라	Santa Clara
카타르	Qatar
프랑스	Pháp
독일	Đức
필리핀	Philippines
파키스탄	Pakistan
호주	Nước Úc
네팔	Nepal
미얀마	Myanmar
말레이시아 몰디브	Malaysia Maldives
랑카 스위스	Lanka Switzerland
킴 카다시안	Kim Kardashian
이스라엘	Israel
이탈리아	Ý
힐러리 클린턴	Hillary Clinton
하이 차우	Hải Châu
엘비스 프레슬리	Elvis Presley
에드워드 스노 든	Edward Snowden
캐롤린 리스	Carolyn Reese
오렌지 라인	Cam Ranh
바나	Bà Nà
부이비엔	Bùi Viện
방글라데시	Bangladesh
벨기에	Bỉ
발리	Bali
잉 젠	Ying Zhen
소련	Xô Viết
폴	Thánh Phaolô
테일러 스위프트	Taylor Swift
산 클레멘테	San Clemente
사무엘 깁스	Samuel Gibbs
퀴논	Quy Nhơn
쥬엘츠 벤츄라	Juelz Ventura
존 폴	John Paul
디엔비엔	Điện Biên
캘빈 클라인	Calvin Klein
알리아 재닌	Alia Janine
고원	Tây Nguyên
트라이 디스트릭트	Tri Quận
상하이	Thượng Hải
라틴 아메리카	Mỹ Latin
라파스	La Paz
훙 브엉	Hùng Vương
홍빈	Hong Bin
호앙 안	Hoàng Anh
호아하이	Hòa Hải
에바 카레라	Eva Karera
에리카 폰테스	Erica Fontes
일론 머스크	Elon Musk
대릴 하나	Darryl Hanah
크리스티안 시스마루	Cristian Cismaru
주하이	Chu Hải
부키 나 파소	Buốc-ki-na Pha-xô	Burkina Faso
브리 올슨	Bree Olson
베를린	Béc-lin	Berlin
벨로오리존치	Belo Horizonte
애슐리 오리온	Ashli Orion
앰버 레인	Amber Rayne
앨리슨 티엔	Alison Thiên
알리시아 티엔	Alicia Thiên
알라나 에반스	Alana Evans
계림	Quế Lâm
판 티엣	Phan Thiết
팔라시오 발데라바노스	Palacio Valderrabanos
마리아	Maria
무이네	Mũi Né
리사 앤	Lisa Ann
코창	Koh Chang
캄 리메이크	Kam Remake
조셉 스미스	Joseph Smith
존스 랭	Jones Lang
제니퍼 로페즈	Jennifer Lopez
브리트니 앰버	Britney Amber
베이징 싼리툰	Beijing Sanlitun
뱅뱅	Bang Bang
아리아나 그란데	Ariana Grande
아마이 리우	Amai Liu
앨리스 로메인	Alice Romain
알파 로미오	Alfa Romeo
웨장 종	Yuejiang Zhong
짱안	Tràng An
타임 스퀘어	Times Square
솔라리아 니시테츠	Solaria Nishitetsu
산타 모니카	Santa Monica
후지	Phú Sĩ
오사카 홋코	Osaka Hokko
노트르담	Nhà thờ Đức Bà	Notre-Dame
마르코 폴로	Marco Polo
끼엔장	Kiên Giang
줌마 무바라크	Jumma Mubarak
좀티엔 카오	Jomtien Khao
존스 홉킨스	Johns Hopkins
제이다 스티븐스	Jada Stevens
하인즈 프랙츠	Heinz Fractz
하코네 고와키엔	Hakone Kowakien
그레이시 글램	Gracie Glam
조지 메이슨	George Mason
포춘 히야	Fortune Hiya
엘 란초	El Rancho
카사 루랄	Casa Rural
캠브리아 스위트	Cambria Suites
앨리슨 타일러	Alison Tyler
알렉산더 트루칸	Alexander Trukan
아그리투리스모 르	Agriturismo Le
아돌프 히틀러	Adolf Hitler
퉁 차우	Tùng Châu
슈퍼 명상	Thiền Siêu
타지키스탄 소비니	Tajikistan Somoni
나카모토 사토시	Satoshi Nakamoto
세인트 폴	Saint Paul
레지덴자 라구나	Residenza Laguna
롱하우	Long Hậu
조르지오 아르마니	Giorgio Armani
지나 린	Gina Lynn
지아 훙	Gia Hưng
엘튼 존	Elton John
양쯔강	Dương Tử
DrTuber 차우	DrTuber Châu
다 빈치	Da Vinci
클라우디아 아담스	Claudia Adams
순결 린	Chastity Lynn
채플 힐	Chapel Hill
벤 탄	Bến Thành
알리사 리스	Alyssa Reece
신화	Tân Hoa
심양	Thẩm Dương
손트라	Sơn Trà
산호세	San José
롱카운티	Quận Long
프라 나콘	Phra Nakhon
팡아	Phang Nga
선거일	Ngày Bầu Cử
뉴햄프셔	New Hampshire
민 차우	Minh Châu
메건 월	Megan Wall
마크 주커 버그	Mark Zuckerberg
루 웨이빙	Lu Weibing
루이 뷔통	Louis Vuitton
크리시 린	Krissy Lynn
케이트 울포드	Kate Wolford
존 싱어	John Singer
제시카 알바	Jessica Alba
제이든 제임스	Jayden Jaymes
후이 호앙	Huy Hoàng
만리장성	Vạn Lý Trường Thành
지지 하디드	Gigi Hadid
즈엉 속	Dương Sóc
다이롱	Đại Long
구룡	Cửu Long
체코 공화국	Cộng Hòa Séc
클로드 모네	Claude Monet
저우 저우	Chu Châu
웨스텔라 콜로니얼	Westella Colonial
와와 타리파	Wawa Tarifa
발레리 케이	Valerie Kay
1월	Tháng Giêng
사파 엘레강스	Sapa Elegance
프리 안키	Pri Ancki
펜션 그레고리	Pension Gregory
판시온 마리아	Pansion Maria
니콜 애니스톤	Nicole Aniston
난드롤론 키피오네이트	Nandrolone Cypionate
마운트 페이버	Mount Faber
러스트 갓	Lust Gat
랏크라방	Lat Krabang
코사메드	Ko Samed
존 레논	John Lennon
자나 요르단	Jana Jordan
자나 코바	Jana Cova
손호앙	Hoàng Sơn
엘도라도	El Dorado
딘 햄릿	Dean Hamlet
오가와 아사미	Asami Ogawa
아브라함 링컨	Abraham Lincoln
휘트니 휴스턴	Whitney Houston
테일러 로페스	Taylor Lopes
남아메리카	South America
상수시	Sans Souci
사메드 타니	Samed Thanee
레알 브라질	Real Brazil
라마잘 시골	Ramajal Rural
라제 레지던스	Raje Residence
레이첼 쉬	Rachel Xu
펜션 아사히	Pension Asahi
패트릭 영	Patrick Young
노던 브리즈	Northern Breeze
노스 다코타	North Dakota
노스 캐롤라이나	North Carolina
르로이 소머	Leroy Somer
르 탄종	Le Tanjong
라스팔마스	Las Palmas
켈리 디바인	Kelly Divine
카사 카티아	Kasa Katia
주앙 페소아	João Pessoa
존 스노우	Jon Snow
제니 모	Jenny Mo
그레타 툰 버그	Greta Thunberg
대 브리튼 섬	Great Britain
이스트런던	East London
돌리 버스터	Dolly Buster
쿤산	Côn Sơn
카를교	Charles Bridge
카이엔 클라인	Cayenne Klein
벤자민 프랭클린	Benjamin Franklin
아보다 자라	Abhodah Zarah
아벨 태즈먼	Abel Tasman
대륙	Đại Lục
반 고흐	Van Gogh
쉬 차우	Từ Châu
탑 바	Tháp Bà
탄 하	Thanh Hà
탄 손	Tân Sơn
소피 문	Sophie Moone
실리카겔	Silica Gel
상 호세	Sao Jose
티엔 지구	Quận Thiên
포우사다 비리비리	Pousada Biribiri
폴카 도트	Polka Dot
피엔응우	Phiên Ngung
펜조나트 에덴	Pensjonat Eden
파나마 발보아	Panaman Balboa
오르페크 Azurelite	Orphek Azurelite
몬테카를로	Monte Carlo
매트 컷츠	Matt Cutts
리 투	Lý Tư
런던 빅토리아	London Victoria
라오까이	Lào Cai
고베 도요	Kobe Toyo
조던 애쉬	Jordan Ash
제시카 제이메스	Jessica Jaymes
제나 헤이즈	Jenna Haze
한탄	Hán Thanh
홍 응옥	Hồng Ngọc
엘 미라솔	El Mirasol
이스틴 타이베이	Eastin Taipei
딘 레일	Din Rail
대시 캠	Dash Cam
크리스티 맥	Christy Mack
캠남	Cam Nam
박닌	Bắc Ninh
크리스티안	Cristian
브레앤 벤슨	Breanne Benson
백스트리트 보이즈	Backstreet Boys
센토사 섬	Đảo Sentosa
틱밀 유럽	Tickmill Europe
싱가포르 강	Sông Singapore
미시시피 강	Sông Mississippi
스와지 릴랑게니	Swazi Lilangeni
스텔라 루멘스	Stellar Lumens
남아프리카	South Africa
신 찬	Shin Chan
살바도르 달리	Salvador Dali
라일리 리드	Riley Reid
로드 아일랜드	Rhode Island
월스트리트	Phố Wall
펜션 아마데우스	Pension Amadeus
응옥 안	Ngọc Anh
닐 파텔	Neil Patel
모로코	Mộc Lan
민카이	Minh Khai
메이요 클리닉	Mayo Clinic
람 응이	Lâm Nghi
라 페르메	La Ferme
카니 예 웨스트	Kanye West
카날 이스탄불	Kanal Istanbul
아이시스 테일러	Isis Taylor
헝수이	Hành Thủy
장시	Giang Tây
페더럴 웨이	Federal Way
에블린 린	Evelyn Lin
엘 고르도	El Gordo
뎀시 힐	Dempsey Hill
데미 로바 토	Demi Lovato
꾸 차우	Cù Châu
클린 내분비	Clin Endocrinol
신디 하이	Cindy Hy
찰스 다윈	Charles Darwin
캔디 맨슨	Candy Manson
레알 카미노	Camino Real
카바나 리페	Cabana Lipe
브리트니 스카이	Brittney Skye
밥 말리	Bob Marley
밥 딜런	Bob Dylan
빌 클린턴	Bill Clinton
방룸푸 플레이스	Banglumpoo Place
아우를란트 피요르드호텔	Aurland Fjordhotel
대서양 펜던트	Atlantik Pendant
아르 데코	Art Deco
아놀드 슈왈제네거	Arnold Schwarzenegger
안젤리카 팀	Angelica Tim
알렉시스 파	Alexis Pha
알렉스 곤즈	Alex Gonz
Agarscents 바자	Agarscents Bazaar
동화	Đông Hoa
동 싱강	Dong Xingang
우본라차타니	Ubon Ratchathani
산시	Thiểm Tây
실비아 세인트	Silvia Saint
카라스마 시조	Shijo Karasuma
세인트 빈센트	Saint Vincent
사비 방콕	Sabye Bangkok
루엔 콴	Ruen Kwan
레알 브라질BRL	Real BraxinBRL
라파엘 애틀랜틱	Rafael Atlantic
난산구	Quận Nanshan
하이주 구	Quận Haizhu
광시	Quảng Tây
프라하 골든	Prague Golden
포르투 토레스	Porto Torres
포르쉐 카이엔	Porsche Cayenne
푼사 서비스드	Poonsa Serviced
피레 마푸	Pire Mapu
순례자 예약	Pilgrim Reservations
피콜리노 하이드	Piccolino Hyde
푹 차우	Phúc Châu
펜션 레샤	Pension Ressha
전원 패널	Panel Năng
팜 비치	Palm Beach
팔라초 델로	Palazzo Dello
니즈니 노브고로드	Nizhny Novgorod
미셸 오바마	Michelle Obama
마스터론 에난테이트	Masteron Enanthate
로칸다 카발리	Locanda Cavalli
라스페치아	La Spezia
크라비 헤리티지	Krabi Heritage
키노타케 토노사와	Kinnotake Tonosawa
켄팅 코지	Kenting Cozy
저스틴 졸리	Justine Joli
준 론	Jun Ron
존 크로닌	John Cronin
조디 웨스트	Jodi West
저지시티	Jersey City
팹 갓	Fap Gat
엘 카미노	El Camino
다르 코람	Dar Coram
다코타 스카이	Dakota Skye
코르시카 페리	Phà Corsica
크리스틴 응우옌	Christine Nguyen
차이나타운	China Town
칼 헨리	Carl Henry
부르 즈 칼리파	Burj Khalifa
바이아 치아	Baia Chia
반 깨우	Baan Kaew
앤아버	Ann Arbor
안젤리나 발렌타인	Angelina Valentine
에어 유로파	Air Europa
타이중	Đài Trung
옌짱	Yến Trang
엑스웨니 베이	Xwejni Bay
윌리엄 힐	William Hill
빈훙	Vĩnh Hưng
트엉 안	Trường An
트리우 즈엉	Triều Dương
도쿄 하네다	Tokyo Haneda
탄 김	Tân Kim
주니어 스위트	Suite Junior
스피디 슬리브	Speedi Sleeve
시 아유타야	Si Ayutthaya
톱날	Saw Blades
사눅 방콕	Sanook Bangkok
산 마리노	San Marino
레이 밴	Ray Ban
칭다오 밍주	Qingdao Mingzhu
푸에르토 발라타	Puerto Vallarta
푸옹 안	Phương Anh
남인도	Nam Ấn
마이 카오	Mai Khao
레이 준	Lei Jun
르망	Le Mans
라 그로타	La Grotta
경남	Kyung Nam
케이티 조딘	Katie Jordin
칼 라거 펠트	Karl Lagerfeld
제임스 딘	James Deen
홍화	Hoa Hồng
하모니 로즈	Harmony Rose
할리 데이비슨	Harley Davidson
기네스 팰트로	Gwyneth Paltrow
그란디내비	Grandi Navi
소녀 단	Girl Scout
가루다 인도네시아	Garuda Indonesia
에리카 로렌	Erica Lauren
엔터프라이즈 리눅스	Enterprise Linux
엠마 왓슨	Emma Watson
에밀리 애디슨	Emily Addison
엘리자베스 2세	Elizabeth II
에드바르 뭉크	Edvard Munch
닥터튜버 퀸	DrTuber Hậu
딜리언 하퍼	Dillion Harper
다나 디어먼드	Dana Dearmond
칸토	Cần Thơ
컬루 코티지	Curlew Cottage
코스타 브라바	Costa Brava
친퀘테레	Cinque Terre
시카고 팟	Chicago Phát
카탈리나 테일러	Catalina Taylor
카시 제임스	Casi James
캡틴 아메리카	Captain America
빈다오	Bình Dao
브루노 마스	Bruno Mars
브리아나 프로스트	Brianna Frost
베이징 후통	Beijing Hutong
안 시앙	Ann Siang
앤 마리	Ann Marie
알리사 밀라노	Alyssa Milano
알렉산더 베레즈노프	Alexander Berezhnov
알레아 아파트	Alea Apartments
아카네 호타루	Akane Hotaru
아드리아나 세이지	Adriana Sage
독일 렉스로스	Đức Rexroth
동 아프리카	Đông Phi
빈펄랜드	Vinpearl Land
투르크메니스탄 마나트	Turkmenistan Manat
터보 개렛	Turbo Garrett
예술 학교	Trường Nghệ Thuật
중앙아프리카	Trung Phi
타이 응우옌	Thái Nguyên
순더	Thuận Đức
타이페이 트리플	Taipei Triple
소피아 트란	Sophia Tran
레지던스 베르제르	Residence Bergère
파블로 피카소	Pablo Picasso
니콜라이 이바노비치	Nikolai Ivanovich
러시아 블라디미르	Nga Vladimir
넬리 설리반	Nelly Sullivan
닐 켈리	Neal Kelley
나리타 토부	Narita Tobu
사우스 캐롤라이나	Nam Carolina
멜레티 비블론	Meleti Vivlon
마자르 폴스키	Magyar Polski
매홍	Mae Hong
랴오닝	Liêu Ninh
라스 가우나스	Las Gaunas
카오락	Khao Lak
이계란	Keiran Lee
키아니 레이	Keeani Lei
조엘 추아	Joel Chua
지즈 벙커	Jizz Bunker
제프 베조스	Jeff Bezos
재스민 린	Jasmine Lynn
하이난	Hải Nam
헨리 포드	Henry Ford
하미	Hà My
에드 시런	Ed Sheeran
데뎀 부티크	Dedem Boutique
쿤밍	Côn Minh
청이	Cherng Yi
청민	Cherng Min
바토파르 파리	Batofar Paris
아베 마리아	Ave Maria
아니사 케이트	Anissa Kate
인도	Ấn Độ
요시오카 학교	Trường Yoshioka
양숴 서더	Yangshuo Sudder
붕따우	Vũng Tàu
Uy Nhat	Uy Nhật
자시	Từ Khê
트랜스유로파 페리	Phà Transeuropa
투득	Thủ Đức
태드 페인	Tad Fane
손퉁	Sơn Tùng
손트라	Sơn Trà
시에라리온	Sierra Leonean
시에라리온	Sierra Leone
쏘팔메토	Saw Palmetto
산타 로사	Santa Rosa
몽고메리 카운티	Quận Montgomery
호앙 지구	Quận Hoàng
바오안 지구	Quận Baoan
필립 아일랜드	Phillip Island
노스 쇼어	North Shore
니와스 아유타야	Niwas Ayutthaya
마크 트웨인	Mark Twain
마릴린 먼로	Marilyn Monroe
칸 호아	Khánh Hòa
카이 호안	Khải Hoàn
켄팅 미라	Kenting Mira
카챠 카신	Katja Kassin
젤소프트 엔터프라이즈	Jelsoft Enterprises
자넷 메이슨	Janet Mason
헤이즈 밸리	Hayes Valley
걸프만	Gulf Coast
프랭크 시나트라	Frank Sinatra
엘라 밀라노	Ella Milano
두바이	Dubai
데시 인도	Desi Ấn
하르	Cáp Nhĩ
코퍼스 크리스티	Corpus Christi
카나리아 부티크	Canary Boutique
북마리아나	Bắc Mariana
노스 다코타	Bắc Dakota
브라이언 트레이시	Brian Tracy
아리엘라 페레라	Ariella Ferrera
아리엘라 부티크	Areela Boutique
아파트호텔 다비즈	Aparthotel Davids
앤 페이버	Anne Faber
안젤리나 카스트로	Angelina Castro
아멜리아 에어하트	Amelia Earhart
인도차이나	Đông Dương
산 베이	Vịnh San
윈난	Vân Nam
과학 학교	Trường Khoa Học
쩐 두이	Trần Duy
통 나이	Thung Nai
탄안	Tân An
사우스 캐롤라이나	South Carolina
셴젠	Shen Zhen
사삭정원	Sasak Garden
성사판	Saphan Sung
산타 시타	Santa Cita
산페드로	San Pedro
샌버나디노	San Bernardino
루나 와시	Runa Wasi
롱삼로엠	Rong Samloem
리야드 아다리사	Riad Adarissa
용화구	Quận Longhua
유고슬라비아	Nam Tư
난퉁	Nam Thông
남하이	Nam Hải
마이안	My An
마이 암	Mai Am
김마	Kim Mã
카오산	Khao San
켄 윌버	Ken Wilber
켈리 매디슨	Kelly Madison
가와구치코 컨트리	Kawaguchiko Country
카랑 메사리	Karang Mesari
후가파이	Hugga Pai
우크라이나 흐리브냐	Hryvnia Ucraina
호앙롱	Hoàng Long
힐튼 가든	Hilton Garden
길리 아이르	Gili Air
엘레나 그리말디	Elena Grimaldi
오로라	Dương Minh
드릴 비트	Drill Bit
다우 존스	Dow Jones
동쑤언	Đồng Xuân
돈키호테	Don Quijote
돈 벡	Don Beck
드 에레라	De Herrera
데이비드 게타	David Guetta
다니엘라 러쉬	Daniella Rush
다니엘 웰링턴	Daniel Wellington
크롤러 불도저	Crawler Bulldozer
쉐보레 크루즈	Chevrolet Cruze
베일론	Bắc Lôn
부티크 산	Boutique San
브라이스 인형	Blythe Doll
베티 크로커	Betty Crocker
버니 샌더스	Bernie Sanders
베이하이 안뜰	Beihai Courtyard
비치 버기	Beach Buggy
배턴루지	Baton Rouge
부딪힌 콰	Banged Qua
앤디 앤더슨	Andi Anderson
안빈	An Bình
암포무앙	Amphoe Mueang
아마존 방갈로	Amazon Bungalow
매력 란제리	Allure Lingerie
악조 노벨	Akzo Nobel
AC 밀란	AC Milan
요코하마 칸나이	Yokohama Kannai
볼보 보컴	Volvo Vocom
버논 맥기	Vernon McGee
벨로치 페리	Phà Veloci
우츠노미야 토부	Utsunomiya Tobu
도쿄 베이	Tokyo Bay
톈진 춘위안	Tianjin Chunyuan
세인트 루크	Thánh Luca
손나콘	Son Nakhon
솔레노이드 밸브	Solenoid Valves
시라하마 우미노야도	Shirahama Uminoyado
차오 상허지아	Shanghejia Cao
레미 길레	Rémi Guillet
강도 밥	Robbery Bob
레이나 크리스티나	Reina Cristina
낭 지구	Quận Năng
응안 지구	Quận Ngân
핑야오 바이창홍	Pingyao Baichanghong
푸옥탄	Phuoc Thanh
프라 수코타이	Phrae Sukhothai
쁘띠 메종	Petite Maison
오사카 난바	Osaka Namba
오르페크 아마조나스	Orphek Amazonas
오비히로 츄오	Obihiro Chuo
노아코인 돗토코무	Noakoin Dottokomu
닉 레흐트	Nick Recht
플라스틱 배럴	Nhựa Thùng
나하우	Nha Hậu
남 쑤언	Nam Xuân
남 수단	Nam Sudan
모쿠효 신문	Mokuhyou Shinbun
민 스벤스카	Minh Svenska
메리 앤	Mary Anne
마리오 히라노	Mario Hirano
메종 달리	Maison Dali
마디 야 프라데시	Madhya Pradesh
매켄지 피어스	Mackenzee Pierce
로스 아르코스	Los Arcos
라 고메라	La Gomera
라 플라멩카	La Flamenka
코팡안	Koh Phangan
코콩	Koh Kong
고창	Ko Chang
카오산 교토	Khaosan Kyoto
켄드라 정욕	Kendra Lust
칸차나부리 크라비	Kanchanaburi Krabi
캄퐁 글램	Kampong Glam
캐그니 카터	Kagney Karter
줄리어스 시저	Julius Caesar
이즈미야 젠베	Izumiya Zenbe
인디아나 존스	Indiana Jones
이안 에릭스	Ian Erix
호이안	Hội An
헝가리어	Hungary
홀리 할스턴	Holly Halston
호앙꾸옥	Hoàng Quốc
호앙 둥	Hoàng Dung
다나카 히토미	Hitomi Tanaka
하코네 고라	Hakone Gora
글렌 레이븐	Glen Raven
기타 마할	Geeta Mahal
프레드 올슨	Fred Olsen
무화과나무 미크로카르파	Ficus Microcarpa
양저우	Dương Châu
돌비 애트모스	Dolby Atmos
Dell 위도	Dell Latitude
데비 랜즈먼	Debby Landesman
드니로	De Niro
대릴 미드	Darryl Mead
코리아 콘도	Corea Condo
코카콜라	Coca Cola
찰스 디킨스	Charles Dickens
싱가포르 창이	Changi Singapore
셀린 디온	Celine Dion
카산드라 닉스	Cassandra Nix
평양	Bình Nhưỡng
브룩 리	Brooke Lee
브리타니 페리	Brittany Ferries
영국항공	British Airways
브렛 로시	Brett Rossi
브렌트 옥슬리	Brent Oxley
브라츠 클로이	Bratz Cloe
베나하비스	Benahavís
베이 브릿지	Bay Bridge
아유타야 방콕	Ayutthaya Bangkok
아요제 페레즈	Ayoze Perez
앤디 산	Andy San
알루라 젠슨	Alura Jenson
앨리 앤	Ally Ann
앨리슨 와이트	Allison Wyte
타이난	Đài Nam
유후인 산토우칸	Yufuin Santoukan
예술대학	Trường Đại học Mỹ Thuật
빅토리아 웰니스	Vittoria Wellness
웨이하이	Uy Hải
어바나 아돌포	Urbana Adolfo
후쿠시마현	Tỉnh Fukushima
대서양	Tây Dương
소흥	Thiệu Hưng
소림	Thiếu Lâm
타오 디엔	Thảo Điền
타이빈	Thái Bình
손 테이	Sơn Tây
스턴 와서	Stern Wasser
스티븐 호킹	Stephen Hawking
세인트 앤드류스	St Andrew
리코 아피시오	Ricoh Aficio
꽝쭝	Quang Trung
풀만 다낭	Pullman Danang
포사다 아자하르	Posada Azahar
피에조 세라믹	Piezo Ceramic
피닉스 마리	Phoenix Marie
팜팡가 카릴	Pampanga Karylle
오이스터 퍼페츄얼	Oyster Perpetual
올랜도 메트로폴리탄	Orlando Metropolitan
노르웨이 크로네	Norwegian Krone
노스링크 페리	Phà Northlink
낫꽝	Nhật Quang
무하 부티크	Mucha Boutique
미쓰비시 파제로	Mitsubishi Pajero
메콩 참	Mekong Charm
머라이어 캐리	Mariah Carey
롱베이	Long Bay
런던 히드로	London Heathrow
로그 코티지	Log Cottage
르 홍	Lê Hồng
크로아티아 쿠나	Kuna Croatia
코 리페	Ko Lipe
카오야이 테라조	Khaoyai Terrazzo
켈라이트 밸브	Kelite Valve
카일라 카레라	Kayla Carrera
캔디 로얄	Kandy Royal
존스 크릭	Johns Creek
조니 성	Johnny Castle
제트 프라이빗	Jet Private
제프 스타	Jeff Starr
일본항공	Japan Airlines	hãng hàng không Nhật Bản
자이르 보우소나루	Jair Bolsonaro
이사벨라 소프라노	Isabella Soprano
아이작 뉴턴	Isaac Newton
이오스 코라	Ios Chora
일리아 바실리예비치	Ilya Vasilyevich
호아빈	Hòa Bình
힐튼 싼야	Hilton Sanya
하포드 카운티	Harford County
구스타프 클림트	Gustav Klimt
광저우 중	Guanghzou Trung
그랜드 로렐	Grand Laurel
고투 콜라	Gotu Kola
지나 바달라티	Gina Badalaty
젠볼트 하이	Genvolt High
포트웨인	Fort Wayne
에라스무스 문두스	Erasmus Mundus
에밀리아 로마냐	Emilia Romagna
엘리자베스 앤	Elizabeth Ann
엘리 릴리	Eli Lilly
에크하르트 톨레	Eckhart Tolle
돌리 파튼	Dolly Parton
들루히 오예즈드	Dlouhý Újezd
클락 칼리지	Clark College
시타딘 베이프런트	Citadines Bayfront
끼아라 페라니	Chiara Ferragni
카프리 앤더슨	Capri Anderson
케이프 커내버럴	Cape Canaveral
뷰로베리타스	Bureau Veritas
부퀘버스 페리	Phà Buquebus
브리트니 스티븐스	Britney Stevens
브레드 피트	Brad Pitt
보카 라톤	Boca Raton
밥 존스	Bob Jones
빈민	Bình Minh
벤 리슨	Bến Nghé
베이징 하이드	Beijing Hyde
아우라 타치바나	Aura Tachibana
아시아 마일즈	Asia Miles
아사쿠사 본점	Asakusa Honten
알제리 영사관	Lãnh sự quán Algeria
알렉산더 맥퀸	Alexander McQueen
알레타 즈엉	Aletta Dương
알 아인	Al Ain
아담 스미스	Adam Smith
막탄 섬	Đảo Mactan
동독	Đông Đức
우쑤언	Xuan Wu
쑤언록	Xuân Lộc
블라디미르 푸틴	Vladimir Putin
빅토리아 베컴	Victoria Beckham
비아사트 우크라이나	Viasat Ukraina
발렌티나 나피	Valentina Nappi
자금성	Tử Cấm Thành
외국인학교	Trường Ngoại Ngữ
쭝 치	Trung Chi
트랜스만체 페리	Phà Transmanche
톤덕	Ton Duc
바티칸 시국	Thành Vatican
텍사스 홀덤	Texas Holdem
다카야마 관광	Takayama Kanko
스벤스카 단스크	Svenska Dansk
스위트 니산타시	Suites Nisantasi
스테로이드 난드롤론	Steroid Nandrolone
솔로 윌리엄	Soleau William
스코다 옥타비아	Skoda Octavia
신주쿠 교엔	Shinjuku Gyoen
산 마테오	San Mateo
산 루이스	San Luis
삼센 헤리티지	Samsen Heritage
로코 시프레디	Rocco Siffredi
국가 우크라이나	Quốc gia Ukraine
평창 에델바이스	Pyeongchang Edelweiss
판추	Phan Chu
팻 포가티	Pat Fogarty
패리스 힐튼	Paris Hilton
일본 도쿄	Nhật Tokyo
응우옌 후에	Nguyễn Huệ
넬슨 만델라	Nelson Mandela
미케	Mỹ Khê
무에타이	Muay Thái
모건 스탠리	Morgan Stanley
매스 빠통	Mass Patong
만다린 오리엔탈	Mandarin Oriental
랩 유치권	Lạp Liên
루 반	Lưu Vân
루아나 스피네티	Luana Spinetti
린킨 파크	Linkin Park
쿠오 슈아이	Kuo Shuay
쿵푸	Kung Fu
칸 호아	Khánh Hòa
케빈 멀둔	Kevin Muldoon
케리 루이스	Kerry Louise
켑 방갈로	Kep Bungalows
카트리나 크레이븐	Katrina Kraven
케이티 콕스	Katie Kox
케이트 윈슬렛	Kate Winslet
저스틴 팀버레이크	Justin Timberlake
보석 옥	Jewels Jade
제트 스키	Jet Ski
지저스 크리스토	Jesus Cristo
제시 로저스	Jessie Rogers
제시 앤드류스	Jessie Andrews
제나 프레슬리	Jenna Presley
자넷 잭	Janet Jacme
잭 콘필드	Jack Kornfield
이방카 트럼프	Ivanka Trump
이스코마르 페리	Iscomar Phà
하우장	Hậu Giang
황산 톈두	Huangshan Tiandu
하워드 휴즈	Howard Hughes
헤더 스타렛	Heather Starlet
한팅 익스프레스	Hanting Express
한나 힐튼	Hannah Hilton
하지 레인	Haji Lane
그랜트 우드	Grant Wood
그랜드슬램	Grand Slam
자바오	Gia Bảo
조지아 존스	Georgia Jones
지오메트리 대시	Geometry Dash
젬마 수쿰빗	Gemma Sukhumvit
두이 안	Duy Anh
동킨	Đông Kinh
다루 히즈로	Darul Hijroh
다스 베이더	Darth Vader
칸 마우	Cân Mậu
크리스티아누 센토	Cristiano Cento
코르푸 타운	Corfu Town
메디나 마켓	Chợ Medina
크리스찬 디올	Christian Dior
찰리 채플린	Charlie Chaplin
충전 컨트롤러	Charge Controller
차오프라야	Chao Phraya
카산드라 칼로제라	Cassandra Calogera
카이트 투르한	Cahit Turhan
브루클린 리	Brooklyn Lee
브라츠 사샤	Bratz Sasha
보르고 피아지아렐라	Borgo Piaggiarella
본조비	Bon Jovi
빈탄	Bình Tân
바이 다이	Bãi Dài
오스틴 킨케이드	Austin Kincaid
아르반 사베티안	Arvand Sabetian
아덴 대학교	Arden University
아파치 스파크	Apache Spark
아오낭 크라비	Aonang Krabi
안수 파티	Ansu Fati
안나 마리아	Anna Maria
알리나 리	Alina Li
에이미 애디슨	Aimee Addison
히메노 아이	Ai Himeno
Aerolineas 아르헨티나	Aerolíneas Argentinas
둑하	Đức Hà
로드 아일랜드	Đảo Rhode
코 아일랜드	Đảo Ko
국민당	Đảng Quốc Dân
탕산	Đường Sơn
중한 페리	Phà Zhonghan
잔테 페리	Phà Zante
워터 파크	Water Park
워릭 모터	Warwick Motor
마리나 베이	Vịnh Marina
우루룬 가와구치코	Ururun Kawaguchiko
웨스트 센트럴	Tây Trung
서쪽 호수	Tây Hồ
투안 안	Tuấn Anh
쩐장	Trấn Giang
종하이	Trung Hải
타미 힐피거	Tommy Hilfiger
타이 차우	Thái Châu
탑 루아	Tháp Rùa
탄퐁	Thanh Phong
탕롱	Thăng Long
소유	Tây Hồ
타냐 테이트	Tanya Tate
탐본시	Tambon Si
스리 마리암만	Sri Mariamman
최수희	Soohee Choi
시부야 토부	Shibuya Tobu
페리 스캔라인	Phà Scandlines
상 프란시스코	Sao Francisco
루이 하이	Rui Hai
레지 모디일	Reji Modiyil
프레스티지오 멀티폰	Prestigio MultiPhone
핑야오 자신	Pingyao Jiaxin
필리핀항공	Philippine Airlines
박총	Pak Chong
파이푸노 케무리	Paipuno Kemuri
오리오스발도 코스타	Oriosvaldo Costa
누사 렘봉안	Nusa Lembongan
니콜라 테슬라	Nikola Tesla
니키 벤츠	Nikki Benz
응우옌 안	Nguyễn Anh
남호주	Nam Úc
나이 한	Nai Harn
나고야 니시키	Nagoya Nishiki
민안	Minh An
매시 퍼거슨	Massey Ferguson
마리오 브라더스	Mario Bros
마가렛 조	Margaret Cho
루카스 후커	Lucas Hooker
라호야	La Jolla
라 코미디	La Comédie
케이지도샤 켄사	Keijidousha Kensa
케이 파커	Kay Parker
카스퍼스키 시큐어	Kaspersky Secure
가루이자와 호텔	Karuizawa Hotel
카이아 거버	Kaia Gerber
줄리아 카메론	Julia Cameron
후안 카를로스	Juan Carlos
제지벨 본드	Jezebelle Bond
재클린 트엉	Jaclyn Trường
하이 투	Hải Thự
하우스텐	Huis Ten
황민	Hoàng Minh
김황	Hoàng Kim
호앙 디우	Hoàng Diệu
헨더슨 웨이브	Henderson Waves
하바나 신	Havana Sin
하오 안	Hào Anh
고든 램지	Gordon Ramsay
피델 카스트로	Fidel Castro
엘리자베스 맥게베런	Elizabeth McGeveran
딜런 로렌	Dillan Lauren
데이비드 레온하트	David Leonhardt
데이비드 베컴	David Beckham
크리스티아누 호날두의	Cristiano Ronaldo
코마나브 페리	Phà Comanav
척 검버트	Chuck Gumbert
크리스티나 아길레라	Christina Aguilera
카사 바칸체	Casa Vacanze
캘빈 해리스	Calvin Harris
북인도	Bắc Ấn
뷰에나파크	Buena Park
브라이트 어닐링	Bright Annealed
브라이언 딘	Brian Dean
블루 라군	Blue Lagoon
빅 벤	Big Ben
비비 존스	Bibi Jones
벨 에어	Bel Air
벌집 푸켓	Beehive Phuket
비버 빌더	Beaver Builder
빈맥스	Bean Max
베이 지역	Bay Area
반농콕	Ban Nongkok
바자이 펄사	Bajaj Pulsar
반 남탄	Baan Namtarn
아야나 티엔	Ayana Thiên
애틀랜틱시티	Atlantic City
안핑 현	Anping County	Quận An Bình
앤 난바	Ann Nanba
앙겔라 메르켈	Angela Merkel
아난다 우붓	Ananda Ubud
알로하멘토 벨라	Alojamento Bela
알리시아 폭스	Alicia Foxx
알베르 카뮈	Albert Camus
아리안 아스틴	Ahryan Astyn
아구라 힐즈	Agoura Hills
아드리아나 루나	Adriana Luna
아드리안 구두스	Adrian Gudus
아담 램버트	Adam Lambert
아론 코놀리	Aaron Connolly
프리저 아일랜드	Đảo Freezer
동인도 제도	Đông Ấn
다이앤 트렁	Điển Trung
단 푸	Đan Phụ
야마자토노이오리 소에네	Yamazatonoiori Soene
웨일즈	Xứ Wales
워싱턴 주	Washington State
탄 흐엉	Tân Hương
침사	Tsim Sha
티레니아 페리	Phà Tirrenia
티엔푹	Thiên Phúc
탄 반	Thanh Vân
탄롱	Thanh Long
슈퍼 주니어	Super Junior
써니 리온	Sunny Leone
세인트 말로	St Malo
세인트루이스	St Louis
샤리프 라로쉬	Sharif Laroche
산 라파엘	San Rafael
산 마르코스	San Marcos
산 주세페	San Giuseppe
산 페르난도	San Fernando
생 로랑	Saint Laurent
러시 포커	Rush Poker
롭 슈워츠	Rob Schwartz
래칫 타이	Ratchet Tie
레인보우 롯지	Rainbow Lodge
푸에르토 나탈레스	Puerto Natales
포르노 가트	Porn Gat
피터 팬	Peter Pan
오푸스 데이	Opus Dei
닝보 인저우	Ningbo Yinzhou	Ngân Châu Ninh Ba
나 투이	Nha Thụy
나비에라 아르마스	Naviera Armas
몰리 카발리	Molly Cavalli
탄 미카	Mika Tan
머라이언 파크	Merlion Park
메리 제인	Mary Jane
마키베리	Maqui Berry
맨체스터시	Manchester City
맨시티	Man City
뤽 섬	Lục Đảo
린 카터	Linn Karter
레오나르도 다	Leonardo Da
레오 몰도바	Leo Moldovan
르아브르	Le Havre
르 지아	Lê Gia
라스 콜리나스	Las Colinas
란저우	Lan Châu
오스위고 호수	Lake Oswego
라 리오하	La Rioja
라 다르세나	La Darsena
크롱 프레아	Krong Preah
줄스 조던	Jules Jordan
조호바루	Johor Bahru
조 슈스터	Joe Shuster
제시카 드레이크	Jessica Drake
젤레나 젠슨	Jelena Jensen
지프 그랜드	Jeep Grand
제임스 세인트	James St
제임스 딘	James Dean
잭 그릴리쉬	Jack Grealish
홍비나	Hong Vina
황풍	Hoàng Phụng
호아푸옹	Hoa Phượng
헨리 8세	Henry VIII
호파	Haw Par
할리 퀸	Harley Quinn
하코네 유모토	Hakone Yumoto
관우	Quan Vũ
그란비아	Gran Via
공허신	Gonghe Xin
후지 온천지	Fuji Onsenji
페데리코 베르나르데스키	Federico Bernardeschi
파리보르즈 라키니	Fariborz Lachini
페어리 디킨슨	Fairleigh Dickinson
에릭 슈미트	Eric Schmidt
에마뉘엘 마크롱	Emmanuel Macron
엘 토레로	El Torero
오 클레어	Eau Claire
두아 리파	Dua Lipa
도라 벤터	Dora Venter
디볼트 옵테바	Diebold Opteva
데이비드 보위	David Bowie
디엔 콴	Điền Quân
사이프로우 폴삿	Cyfrowu Polsat
암호화폐 주석	CryptoCurrency Tin
콘티넨탈항공	Continental Airlines
콩더 골목	Congde Alley
클라라 모르간	Clara Morgane
신디 크로포드	Cindy Crawford
치아의 사원	Chùa Răng
크리스 마틴	Chris Martin
샤를리즈 테론	Charlize Theron
케이시 칼버트	Casey Calvert
카터 크루즈	Carter Cruise
캐롤 타이스	Carol Tice
케이프 대구	Cape Cod
까오 탄	Cao Thanh
캠 차우	Cẩm Châu
브라이언 클라크	Brian Clark
핑둥	Bình Đông
벤 테니슨	Ben Tennyson
벨라 비스타	Bella Vista
바트 심슨	Bart Simpson
바오 티엔	Bảo Tiên
박당	Bạch Đằng
오브리 아담스	Aubrey Adams
아스펜 스티븐스	Aspen Stevens
앙코르 와트	Angkor Wat
아나 폴라	Ana Paula
아미아 마일리	Amia Miley
어메이즈핏 버지	Amazfit Verge
앨빈 모날	Alvin Monal
앨리 신	Allie Sin
앨리슨 레이	Alison Rey
앨리스 프로스트	Alice Frost
알렉산드라 다다리오	Alexandra Daddario
알라나 나	Alana Nha
앨런 튜링	Alan Turing
에어 아라비아	Air Arabia
어드벤처 파크	Adventure Park
아크로니스 랜섬웨어	Acronis Ransomware
덕홍	Đức Hồng
맨 섬	Đảo Man
닷 탕	Đạt Thắng
장자제 얀란	Zhangjiajie Yanran
와이어 로프	Wire Rope
윈스턴 처칠	Winston Churchill
윌리엄 솔로	William Soleau
위앙 치앙 콩	Wiang Chiangkhong
왓 후아	Wat Hua
워너 브라더스	Warner Bros
벽 와셔	Wall Washer
멕시코만	Vịnh Mexico
발렌틴 샤를라노프	Valentin Sharlanov
쭝 비엣	Trung Việt
텔록 블랑가	Telok Blangah
탄퐁	Tân Phong
타밀나두	Tamil Nadu
타이페이 써니	Taipei Sunny
여름 학교	Summer School
설푸릴 플루오라이드	Sulfuryl Fluoride
엔터프라이즈 스위트	Suite Enterprise
스타터 킷	Starter Kit
셜록 홈즈	Sherlock Holmes
쉐라톤 나	Sheraton Nha
상 가브리엘	Sao Gabriel
산세바스티안	San Sebastian
산 프란체스코	San Francesco
산 카를로스	San Carlos
SJ 오사카	SJ Osaka
로얄 부티크	Royal Boutique
롱메이	Rong Mei
리오 그란데	Rio Grande
르노 클리오	Renault Clio
레베카 밍코프	Rebecca Minkoff
꾸옥딘	Quốc Đình
친양 셴펑	Qinyang Xianfeng
첸강 마린	QianGang Marine
포르쉐 파나메라	Porsche Panamera
푸옥록	Phước Lộc
푸록	Phú Lộc
페리 칸타루티	Perry Cantarutti
페넬로페 크루즈	Penelope Cruz
오사카 우메다	Osaka Umeda
노퍽라인 페리	Phà Norfolkline
응안 차우	Ngân Châu
응우옌 딘	Nguyễn Đình
나이 위엥	Nai Wieng
무앙 치앙	Mueang Chiang
몽블랑	Mont Blanc
민꽝	Minh Quang
밍 준	Ming Jun
메건 마클	Meghan Markle
말레나 모건	Malena Morgan
롱안	Long An
록히드 마틴	Lockheed Martin
록빈	Lộc Vinh
론 프엉	Loan Phượng
원활한	Liền Mạch
린센 로프트	Linsen Loft
랑지 티엣	Langzhi Thiết
랭글리 하이웨이	Langley Hwy
란 투이	Lan Thụy
란 안	Lan Anh
람빈	Lâm Bình
라 바로사	La Barrosa
코란	Koh Larn
키리나 레트로	Kirina Retro
케이티 조던	Katie Jordan
케이트 미들턴	Kate Middleton
칼레나 리오스	Kalena Rios
줄리아 본드	Julia Bond
호르헤 루이스	Jorge Luis
조르디 알바	Jordi Alba
존 존	Jon Jon
존슨 비	Johnson Vee
존 트라볼타	John Travolta
존 럼리	John Lumley
존 제이	John Jay
지미 카터	Jimmy Carter
짐 데노미	Jim Denomie
제시 팔머	Jessi Palmer
지프 랭글러	Jeep Wrangler
자넷 잭슨	Janet Jackson
얀 베르메르	Jan Vermeer
제이미 오팔척	Jamie Opalchuk
제임스 매디슨	James Madison
제임스 해리슨	James Harrison
제임스 블런트	James Blunt
잭 마	Jack Ma
홍뚜옹	Hồng Tưởng
엔 헝	Hưng Yên
황응옥	Hoàng Ngọc
힐러리 더프	Hilary Duff
조반니 바티스타	Giovanni Battista
길만 막사	Gillman Barracks
지아나 마이클스	Gianna Michaels
조지 클루니	George Clooney
포트 마이어스	Fort Myers
파비오 마시모	Fabio Massimo
이브 로렌스	Eve Lawrence
에릭 에버하드	Erik Everhard
엘리자베스 테일러	Elizabeth Taylor
이스트 앵글리아	East Anglia
즈엉 동	Dương Đông
중화 인민 공화국	Dân Quốc
두이 탄	Duy Tân
드류 베리모어	Drew Barrymore
동다	Đống Đa
도널드 덕	Donald Duck
돈 아우렐리오	Don Aurelio
데이비드 허슨	David Hirson
데이비드 앨런	David Allen
달라 크레인	Darla Crane
데인 존스	Dane Jones
다이남	Đại Nam
달랏	Đà Lạt
크룸 하카타	Croom Hakata
컨트리 리트리트	Country Retreat
시스코 기가비트	Cisco Gigabit
크리스토퍼 얀	Christopher Jan
크리스 프랫	Chris Pratt
치니타스 어반	Chinitas Urban
셔닐 대학	Chenille Varsity
찰리 레인	Charlie Laine
차이완	Chai Wan
케이 콜커	Caye Caulker
캐롤 골드네로바	Carol Goldnerova
캄보디아 앙코르	Cambodia Angkor
노동부	Bộ Lao Động
브랜치버그 공원	Branchburg Park
보우플렉스 익스트림	Bowflex Xtreme
블루베이	Blue Bay
블레이드 러너	Blade Runner
부바 해	Biển Buva
빌리 아일리시	Billie Eilish
베이 웨이리히	Bei Weirich
베어 너클	Bare Knuckle
바오안	Bảo An
반얀 트리	Banyan Tree
브라더스 스테이트	Bang Bros
발레아리아 페리	Phà Balearia
베일리 블루	Bailey Blue
배드 고이젠	Bad Goisern
에이브릴 라빈	Avril Lavigne
오드리 홀랜더	Audrey Hollander
아우코	Au Co
애슐리 그레이엄	Ashley Graham
샴푸 굽기	Ashampoo Burning
인조 잔디	Artificial Grass
아피주 펜포	Apiju Fenfo
아네트 슈바르츠	Annette Schwarz
안푸	An Phú
놀이 공원	Amusement Park
암스테르담	Amsterdam
아메리칸 대학교	American University	Trường Đại học American
아메리칸 에어 라인	American Airlines
암브레 그리	Ambre Gris
알리시아 로즈	Alicia Rhodes
앨리스 스프링스	Alice Springs
알렉시스 실버	Alexis Silver
알렉시스 말론	Alexis Malone
알렉사 니콜	Aleksa Nicole
아이리시 페리	Phà Ailen
영순	Yung Soon
옌퐁	Yên Phong
쑤언 응우옌	Xuân Nguyễn
신리 에스쿠터	Xinli Escooter
와이트링크 페리	Phà Wightlink
웨스트 체스터	West Chester
웨이 블레이드	Way Blade
워렌 버핏	Warren Buffett
워드 벤	Ward Ben
파스퇴르 연구소	Viện Pasteur
비키 벤슨	Vickie Benson
따이바	Tây Ba
탄 손	Tân Sơn
투안빈	Tuấn Vinh
쯔엉꾸옥	Trương Quốc
토레마르 페리	Phà Toremar
도쿄 스카이트리	Tokyo Skytree
내셔널 타워	Tháp Quốc Gia
세인트 니콜라스	Thánh Nicholas
스레드 로드	Threaded Rod
통 타니	Thong Thani
톤부리	Thon Buri
토마스 제퍼슨	Thomas Jefferson
테오도어 에어	Theodoor Air
칭하이	Thanh Hải
탄푸	Tân Phú
탄 하이	Tân Hải
탬파베이	Tampa Bay
이태	Tai Lee
타히티안 노니	Tahitian Noni
산터우	Sán Đầu
스이메이칸 카루카야	Suimeikan Karukaya
세인트 존스	St John
송장	Sông Gianh
솽린 지아테	Shuanglin Jiate
상하이항공	Shanghai Airlines
산토 도밍고	Santo Domingo
산타 카탈리나	Santa Catalina
산 파올로	San Paolo
료칸 카미나카	Ryokan Kaminaka
로버트 드	Robert De
리처드 브랜슨	Richard Branson
랄프 왈도	Ralph Waldo
레인포레스트 리트리트	Rainforest Retreat
광명현	Quận Guangming
바이윈 지구	Quận Baiyun
깐난	Quynh Nhan
칭다오 쑹벤	Qingdao Songben
퓨어 머스크	Pure Musk
부관 페리	Phà Pukwan
포이즌 아이비	Poison Ivy
푸옹 투이	Phương Thúy
오스카 와일드	Oscar Wilde
오르페크 나선	Orphek Helix
오라카이 인사동	Orakai Insadong
오클라호마시티	Oklahoma City
노이바이	Nội Bài
닌자 거북이	Ninja Rùa
니콜 키드먼	Nicole Kidman
니키 미나즈	Nicki Minaj
응옥 란	Ngọc Lan
신베이	New Taipei
나사우 홀	Nassau Hall
난징 케우다	Nanjing Keyuda
사우스 플로리다	Nam Florida
나초 비달	Nacho Vidal
무옹 탄	Mường Thanh
무이라 파우마	Muira Pauma
마이애미 공항	Miami Airport
매튜 리	Matthew Lee
마시코칸 사토야마	Mashikokan Satoyama
마리아 페레즈	Maria Perez
마디 그라	Mardi Gras
만다린항공	Mandarin Airlines
록 토	Lộc Thọ
람 투언	Lâm Thuận
카일리 제너	Kylie Jenner
킴 퐁	Kim Phong
키스톤 잭	Keystone Jack
케리린 엥겔	KeriLynn Engel
켄트 릿지	Kent Ridge
켄달 카슨	Kendall Karson
켈리 시바리	Kelly Shibari
켈리 클락슨	Kelly Clarkson
키아누 리브스	Keanu Reeves
케이티 세인트	Katie St
칼리 클로스	Karlie Kloss
카플란 싱가포르	Kaplan Singapore
후안 마누엘	Juan Manuel
조잔케이 만세이카쿠	Jozankei Manseikaku
존슨 와이어	Johnson Wire
존 윅	John Wick
존 메이너드	John Maynard
존 레전드	John Legend
존 도우	John Doe
조안 매드	Joan Mad
진촌 페리	Phà Jinchon
예수 그리스도	Jesus Christ
제시카 심슨	Jessica Simpson
제니 헨드릭스	Jenny Hendrix
제주도	Đảo JeJu
제이슨 코헨	Jason Cohen
일본 엄마	Japanese Mom
재니스 조플린	Janis Joplin
제이미 발렌타인	Jamie Valentine
제임스 브로스만	James Brossman
이사벨라 클라크	Isabella Clark
어바인 밸리	Irvine Valley
레이크 타호	Lake Tahoe
가와구치 호수	Hồ Kawaguchi
하이즈엉	Hải Dương
하얏트 리젠시	Hyatt Regency
흐엉장	Hương Giang
호앙 응우옌	Hoàng Nguyễn
황하	Hoàng Hà
히렌 솔란키	Hiren Solanki
헤스코 바스티온	Hesco Bastion
헤리티지 파크	Heritage Park
헤나 멘디	Henna Mehndi
고급 패션	Haute Couture
하우스 슈트루첸베르거	Haus Strutzenberger
하 히엔	Hà Hiền
그레이트 오르메	Great Orme
그레이스 베이	Grace Bay
지젤 레온	Giselle Leon
지나 디바인	Gina Devine
갈릴레오 갈릴레이	Galileo Galilei
프랭키 스타인	Frankie Stein
포트 콜린스	Fort Collins
에밀리 다빈치	Emily Davinci
엘리너 루즈벨트	Eleanor Roosevelt
엘 히에로	El Hierro
엘 카프리초	El Capricho
에디 머크스	Eddy Merckx
도로시 퍼킨스	Dorothy Perkins
동서울	Đông Seoul
동나이	Đồng Nai
돈 키호테	Don Quixote
도메니코 베라르디	Domenico Berardi
파리 디즈니 랜드	Disneyland Paris
드탐	Đề Thám
데이비드 레터맨	David Letterman
다르 엘	Dar El
다나 수수께끼	Dana Riddle
데일 언하트	Dale Earnhardt
DJI 팬텀	DJI Phantom
꾸 두	Cu Du
Cong Quynh	Cống Quỳnh
식민 살바도르	Colón Salvador
클린 뉴트르	Clin Nutr
시에라 세이지	Ciera Sage
크리스찬 베일	Christian Bale
치치	Chi Chi
찰리 리	Charlie Lee
창티	Chang Tee
카펫 타일	Carpet Tiles
캐롤라인 피어스	Caroline Pierce
카오 트엉	Cao Trường
카나리아 제도	Canary Islands
캄파닐레 리스본	Campanile Lisboa
카메론 크루즈	Cameron Cruise
캠브리아 더럼	Cambria Durham
부에나 비스타	Buena Vista
빈흥	Bình Hưng
육군본부	Bình Định
빌리 롤랜드	Billy Roland
베이징 완두콩	Beijing Peas
바오 트란	Bảo Trần
바오 칸	Bảo Khánh
애저 익스프레스 루트	Azure ExpressRoute
애슐린 레이	Ashlyn Rae
안젤리카 레인	Angelica Lane
안드라프라데시	Andhra Pradesh
마츠다 아미	Ami Matsuda
앰버 알	Amber Al
알레한드라 마데로스	Alejandra Maderos
알버트 트로터	Albert Trotter
알베르고 디퓨소	Albergo Diffuso
앨런 코헨	Alan Cohen
앨런 차오	Alan Cao
앨 고어	Al Gore
아이쉬와라 라이	Aishwarya Rai
아드리아나 리마	Adriana Lima
아델피 대학교	Adelphi University
애디슨 로즈	Addison Rose
아비게일 맥	Abigail Mac
단 즈엉	Đan Dương
에밀 쿠에	Émile Coué
아제르바이잔 오스트리아	Áo Azerbaijan
졸탄 타녹	Zoltán Tárnok
유라리 로쿠묘	Yurari Rokumyo
요시이케 료칸	Yoshiike Ryokan
이란시	Yilan City
비탈릭 부테린	Vitalik Buterin
비엔나 베트남	Vienna Việt Nam
유니언 스퀘어	Union Square
울트라 싱가포르	Ultra Singapore
취안저우	Tuyền Châu
오클리 학교	Trường Oakleigh
트엉 사	Trường Sa
트란조텔 방갈로르	Tranzotel Bangalore
토니 스타크	Tony Stark
톰 포드	Tom Ford
도쿄 신주쿠	Tokyo Shinjuku
도쿄 메트로	Tokyo Metro
투이 반	Thúy Vân
투이 티엔	Thủy Tiên
토마스 에디슨	Thomas Edison
티엔안	Thiên An
티엔팟	Thiên Phát
티엔 응아	Thiên Nga
티엔 김	Thiên Kim
타오 응우옌	Thảo Nguyễn
타오 위안	TAO YUAN	Đào Viên
한강	Sông Hàn
시드니 티라나	Sydney Tirana
스윙 배리어	Swing Barrier
소이 카이묵	Soi Khaimuk
실데나필 메실레이트	Sildenafil Mesylate
사라 셰본	Sarah Shevon
사라센 베이	Saracen Bay
사라 제이	Sara Jay
상 루이스	Sao Luis
해왕성	Sao Hải
산타 테레사	Santa Teresa
산타마르타	Santa Marta
황산살부타몰	Salbutamol Sulfate
로날드 리건	Ronald Reagan
산티아고의 채찍	Roi Santiago
로버트 슈워츠	Robert Schwartz
리뷰 레드만	Recensioni Redman
라타나 부티크	Ratana Boutique
신베이 구	Quận Xinbei
탄 지구	Quận Thanh
군	Quận Hạt
화두구	Quận Huadu
구이저우	Quý Châu
칭다오 홍다	Qingdao Hongda
프리야 라이	Priya Rai
피콜로 푸도	Piccolo Feudo
파룬궁	Pháp Luân
푸옥하이	Phước Hải
푹 로이	Phúc Lợi
난초	Phong Lan
피터 다이	Peter Đại
페루 누에보	Peruvír Nuevo
판나 헤리티지	Panna Heritage
팔로 알토	Palo Alto
온천 니혼슈	Onsen Nihonshu
오볼론스카 부두	Obolonska Quay
에키마에 오비히로	Obihiro Ekimae
러시아	Nga
노팅엄 트렌트	Nottingham Trent
노스 마이애미	North Miami
니시카와구치 에키마에	Nishikawaguchi Ekimae
닝보 베스트클리너	Ningbo BestCleaner
니키타 아누프리예프	Nikita Anufriev
니켈 크롬	Niken Crom
니콜 무어	Nicole Moore
응옥 칸	Ngọc Khánh
나소 퍼스	Nassau Perth
남유센	Nam Yusen
남예레반	Nam Yerevan
남 차오	Nam Cao
모니크 알렉산더	Monique Alexander
메이지	Minh Trị
민탄	Minh Thanh
마이클 위스브런	Michael Wisbrun
마이클 코어스	Michael Kors
미 스와코	Mi Swaco
용융 흐름	Melt Flow
매트 히튼	Matt Heaton
마틴 브릴란트	Martin Vrijland
마크 데이비스	Mark Davis
마리오 카트	Mario Kart
마리아 벨루치	Maria Bellucci
마누엘 페라라	Manuel Ferrara
마나마 멜버른	Manama Melbourne
매림	Mae Rim
라오스 루안다	Lào Luanda
루시 리	Lucy Ly
롱탄	Long Thành
런던 수도	Thủ đô London
로건 피어스	Logan Pierce
린다 레이	Linda Ray
리엔안	Liên An
렉스 아티펙스	Lex Artifex
레오 톨스토이	Leo Tolstoy
이준	Lee Joon
라스 크루세스	Las Cruces
라 메리디오날레	La Méridionale
라 리가	La Liga
코사무이	Koh Samui
킹콩	King Kong
킴 나이키	Kim Nike
김정은	Kim Jong Eun
쿠에 미	Khuê Mỹ
케빈 코스트너	Kevin Costner
켈리 리	Kelly Leigh
케일라 페이지	Kayla Paige
케이티 티엔	Katie Thiên
케이트 스페이드	Kate Spade
가스가 료칸	Kasuga Ryokan
카를 마르크스	Karl Marx
케이시 조던	Kacey Jordan
쥬라기 공원	Công viên Jurassic
줄리안 허프	Julianne Hough
존스 아레나	Jones Arena
존 맨	John Mạnh
존 마샬	John Marshall
요한 세바스찬	Johann Sebastian
조 바이든	Joe Biden
질리언 잰슨	Jillian Janson
제레미 아이언스	Jeremy Irons
제라미 톰슨	Jeramey Thompson
제나 로스	Jenna Ross
장 조셉	Jean Joseph
제이 월재스퍼	Jay Walljasper
제이슨 차우	Jason Chow
제임스 제인스	Jamey Janes
재키 린	Jackie Lin
잭 체다	Jack Cheddar
이솔라 산	Isola San
이오니아 페리	Phà Ionian
국제 대학	Trường Đại học Quốc Tế
화웨이 노바	Huawei Nova
화웨이 소비자	Huawei Consumer
화미 어메이즈핏	Huami Amazfit
호세이대학	Hosei University	Trường Đại học Hosei
홍지압	Hồng Giáp
홍자오	Hồng Giao
홋카이도 시코쿠	Hokkaido Shikoku
한나 하퍼	Hannah Harper
지나 밀라노	Gina Milano
지나 거슨	Gina Gerson
장보	Giang Võ
겐랑	Ghềnh Ráng
프랭클린 파크	Franklin Park
페르난도 요렌테	Fernando Llorente
에바 노티	Eva Notty
에스페란자 고메즈	Esperanza Gomez
에르네스토 발베르데	Ernesto Valverde
어니스트 헤밍웨이	Ernest Hemingway
에릭 루페스	Erik Luppes
에릭 칸토나	Eric Cantona
엡손 스타일러스	Epson Stylus
경험적 Mjk	Empiric Mjk
에밀리아 클라크	Emilia Clarke
엠버시 스위트	Embassy Suites
엘 맥퍼슨	Elle Macpherson
도니타 듄스	Donita Dunes
돈므앙	Don Muang
돈환	Don Juan
도미니카 레오니	Dominica Leoni
데베지 방콕	Dhevej Bangkok
데니스 쿠데린	Denis Kuderin
드 몽포르	De Montfort
데이비드 팻	David Phát
데이비드 카르타	David Carta
단테 알리기에리	Dante Alighieri
다니엘 팻	Daniel Phát
다니 젠슨	Dani Jensen
꾸 롱	Cửu Long
컬투라 이탈리아나	Cultura Italiana
큐빅 지르코니아	Cubic Zirconia
산호초	Coral Reef
산호 박공	Coral Gables
코파항공사	Copa Airlines
콜로세움 크릭	Colosseum Creek
코코 리버사이드	CoCo Riverside
클레어 아담스	Claire Adams
클로이 포스터	Chloe Foster
칠레 다카	Chile Dhaka
치푸	Chi Pu
체리 레인	Cherry Lane
청두 올드	Chengdu Old
첸 웬	Chen Wen
샤토 바쿠스	Chateau Bacchus
샬럿 베일	Charlotte Vale
샤 린	Char Lynn
가나 세디	Cedi Ghana
카사 에차바리아	Casa Echavarria
카레 에덴	Carré Eden
케이프 메이	Cape May
캉사이공	Cảng Sài Gòn
캔버라 영사	Lãnh sự quán Canberra
카밀라 카베요	Camila Cabello
벨기에 페리	Phà Bỉ
벨기에 브리즈번	Bỉ Brisbane
박장	Bắc Giang
박당	Bạch Đằng
아기 엘사	Bé Elsa
바이런 베이	Byron Bay
불치낭트	Bwlch Nant
부바 해	Buva Sea
벌킹추	Bulking Chu
부가티 시론	Bugatti Chiron
영국 문화원	British Council
브리검 영	Brigham Young
브랜든 스미스	Breandon Smith
브레아 베넷	Brea Bennett
브랜디 애니스톤	Brandy Aniston
브레이크 캘리퍼	Brake Caliper
브래드 맥케이	Brad Mackay
보이 스카우트	Boy Scout
보른홀름 페리	Phà Bornholm
폭탄 방해기	Bomb Jammer
볼데논 스테로이드	Boldenone Steroids
밥 힉맨	Bob Hickman
보트	BoaT Quay
청나일	Blue Nile
블리스 레이	Bliss Lei
블랙마트 알파	Blackmart Alpha
블랙 라군	Black Lagoon
빈안	Bình An
벨라 리스	Bella Reese
벨라 앤	Bella Anne
벨고로드 연구소	Viện nghiên cứu Belgorod
베이징 옌치	Beijing Yanqi
베이징 로드꽝	Beijing Road
베클로메타손 디프로피오네이트	Beclomethasone Dipropionate
바바라 부이	Barbara Bùi
바오 응옥	Bảo Ngọc
방글라데시 바쿠	Baku Bangladesh
베이커리 블리츠	Bakery Blitz
바이코누르 우주기지	Baikonur Cosmodrome
바이아 프린시페	Bahia Principe
바하마 바레인	Bahamas Bahrain
배드 호네페	Bad Honnef
아리아 스타크	Arya Stark
예술 박물관	Art Museum
아리안 숲	Arian Forest
아르헨티나	Argentina
아르메니아	Armenia
아프릴리아 스카라베오	Aprilia Scarabeo
안세 코숑	Anse Cochon
안나 폴리나	Anna Polina
안나 마리	Anna Marie
아니타 헹거	Anita Hengher
화난 그란	Angry Gran
안젤리카 레이븐	Angelica Raven
안드리스 피발스	Andris Piebalgs
아나스타시야	Anastasiya
앰버 린	Amber Lynn
알리샤 레인	Alisha Laine
알제리 앙골라	Algiers Angola
알제리 페리	Phà Algeria
알제리	Algeria
알프레드 판지오	Alfréd Panzió
알렉시스 브리즈	Alexis Breeze
알렉산더 그레이엄	Alexander Graham
알렉사 벤슨	Alexa Benson
알 바르샤	Al Barsha
에이든 애슐리	Aiden Ashley
아프가니스탄 알바니아	Afghanistan Albania
아드리아나 체칙	Adriana Chechik
베트남 항공	Vietnam Airlines	hãng hàng không Việt Nam
체코 항공	Czech Airlines
싱가포르 항공	Singapore Airlines
말레이시아 항공	Malaysia Airlines
코파 항공	Copa Airlines
샤먼 항공	Xiamen Airlines
